BXXXXXXXXXXXXXXXXXXXXXXXXXXXFXXXXXXXXXXXXXXXXXXXXXXXXXXXXXXXXXXXXXXXXXXXXXXXXXXXXXXXIXXXXCXXXXCXXXXXCXXXCXXXXXXXXXXB
BXXXXXXXXXXXXXXXXXXXXXXXXXXXXXXXXXXXXXXXXXXXXXXXXXXXXXXXXXXXXXXXXXXXXXXXXXXXXXXXXXXFIXXXXXXXXXXXXXXXXXXXXXXXXXXXXXXB
BXXXXXXXXXXXXXXXXXXXXXXXXXXXXXXXXXXXXXDDVXXXXXXXXIIIIXXXXXXXXXXXXXXXXXXXXXIIIIIIIIIIIXXXXXXXXXXXXXXXXXXXXXXXXXXXXXXB
BXXXXXXXXXXXXXXXXXXXXXXXXXXXXXXXXXXXIIIIIXXXIIIXXIIIIXXXXXXXXXXXXXXXXXXXXXXXXXXXXXDDVXXXXXXXXXXXXXXXXXXXXXXXXXXXXXXB
BXXXXXXXXXXXXXXXXXXXXXXXXXXXXXXXXIXXXXXXXXXXXXXXXIIIIXXXXXXXXXXXXXXXXXXXXXXXXXXXXXDDVXXXXXXXXXXXXXXXXXXXXXXXXXLLLXXB
BXXXXXXXXXXXXXXXXXXXXXXXXXXXXXXXXXXXXXXXXXXXXXXXXIIIIXXXXXXXXXXXXXXXXXXXXIIIIIIIIIIIIXXXXXXXXXXXXXXXXDVDXXXXXXLLLXXB
BXXXXXXXXXXXXXXXXXXXXXXXIIIXXXIXXXXXXXXXXXTXXXXXXIIIIXXXXXXXXXXXXXXXXXXXXXXXXXXXXXXXKXXXXXXXXXXXXXXXXXXXXXXXXXLLLXXB
BXXXXXXXXXXXXXXXXXXXXXXXXXXXXXXXXXXXXXXXXXXXXXXXXIIIIXXXXXXXXXXXXXXXXXXXXXXXXXXXXXXXKXXXXXXXXXXXXXXXXXXXXXXXXXXHXXXB
BXXXXXXXXXXXXXXXXXXXXIIXXXXXXXXXXXXXXXXXXXXXXXXXXIIIIXXXXXXXXXXXXXXXXXXXIIIIIIIIIIIIIXXXXXXXVDDXXXXXXIIIXXXXXXXHXXXB
BXXXXXXXXXDDVXFXXXXXXXXXXXXXXXXXXXXXXXXXXXXXXXXXxXXXIXXXXXXXXXXXXXXXVDDXXXXXXXXXXXXXXXXXXXXXIXXDVDXXXIIIFXXXXXXHXXEB
BXXXXXXXIIIIIIIXXXIIIIIIIXXXXXXXXXXXXXXXXXXXXXXXXXXFIXXXIIXXXXXIXXIIIIIIXXXXXXXXXXXXXXIIIIIIIIIIIIIIIIIIIXXXIIIIIIIB
BIIIIIIIIIIIIIIWWWIIIIIIIIIIIIIIIIIIIIIIIIIIIIIIIIIIIWWWIIIIIIIIWWIIIIIIWWWWWWWWWWWWWWIIIIIIIIIIIIIIIIIIIWWWIIIIIIIB
