BXXXXXXXXXXXXXXXXXXXXXXXXXXXXFXXXXXXXXXXXXXXXXXXXXXXXXXXXXXXXXXXXXXXXXXXXXXXXXXXXXXXXXXXXXXXZXXXXCXXXXCXXXXXCXXXCXXXXXXXXXXXXB
BXXXXXXXXXXXXXXXXXXXXXXXXXXXXXXXXXXXXXXXXXXXXXXXXXXXXXXXXXXXXXXXXXXXXXXXXXXXXXXXXXXXXXXXXXXFZXXXXXXXXXXXXXXXXXXXXXXXXXXXXXXXXB
BXXXXXXXXXXXXXXXXXXXXXXXXXXXXXXXXXXXXXXDDVXXXXXXXXZZZZZXXXXXXXXXXXXXXXXXXXXXXZZZZZZZZZZZZZZZZXXXXXXXXXXXXXXXXXXXXXXXXXXXXXXXXB
BXXXXXXXXXXXXXXXXXXXXXXXXXXXXXXXXXXXXZZZZZXXXZZZXXZZZZZXXXXXXXXXXXXXXXXXXXXXXXXXXXXXXXXXXXDDVXXXXXXXXXXXXXXXXXXXXXXXXXXXXXXXXB
BXXXXXXXXXXXXXXXXXXXXXXXXXXXXXXXXXZXXXXXXXXXXXXXXXZZZZZXXXXXXXXXXXXXXXXXXXXXXXXXXXXXXXXXXXDDVXXXXXXXXXXXXXXXXDVDXXXXXXLLLXXXXB
BXXXXXXXXXXXXXXXXXXXXXXXXXXXXXXXXXXXXXXXXXXXXXXXXXZZZZZXXXXXXXXXXXXXXXXXXXXXZZZZZZZZZZZZZZZZZXXXXXXXXXXXXXXXXXXXXXXXXXLLLXXXXB
BXXXXXXXXXXXXXXXXXXXXXXXXZZZXXXZXXXLLLXXXXXXXXXXXXZZZZZXXXXXXXXXXXXXXXXXXXXXXXXXXXXXXXXXXXXXKXXXXXXXXXXXXXXXXXXXXXXXXXLLLXXXXB
BXXXXXXXXXXXXXXXXXXXXXXXXXXXXXXXXXXLLLXXXXXXXXXXXXZZZZZXXXXXXXXXXXXXXXXXXXXXXXXXXXXXXXXXXXXXKXXXXXXXXXXXXXXXXXXXXXXXXXXHXXXXXB
BXXXXXXXXXXXXXXXXXXXXXZZXXXXXXXXXXXLLLXXXXXXXXXXXXZZZZZXXXXXXXXXXXXXXXXXXXXZZZZZZZZZZZZZZZZZZXXXXXXXVDDXXXXXXZZZXXXXXXXHXXXXEB
BXXXXXXXXXXXDVXFXXXXXXXXXXXXXXXXXXXXHXXXXXXXXXXXXXXXXXKXXXXXXXXXXXXXXXVDDXXXXXXXXXXXXXXXXXXXXXXXXXXDVDDDVDXXXZZZFXXXXXXHXXXXXB
BXXXXXXXZZZZZZZZXXXZZZZZZZXXXXXXXXXXHXXXXXXXXXXXXXXXXFKXXXZZXXXXXZXXZZZZZZXXXXXXXXXXXXXXXXXXXXZZZZZZZZZZZZZZZZZZZXXXZZZZZZZZZB
BZZZZZZZZZZZZZZZWWWZZZZZZZZZZZZZZZZZZZZZZZZZZZZZZZZZZZZWWWZZZZZZZZWWZZZZZZWWWWWWWWWWWWWWWWWWWWZZZZZZZZZZZZZZZZZZZWWWZZZZZZZZZB
