BXXXXXXXXXXXXXXXXXXXXXXXXXXXFXXXXXXXXXXXXXXXXXXXXXXXXXXXXXXXXXXXXXXXXXXXXXXXXXXXXXXXXXXZXXXXCXXXXCXXXXXCXXXCXXXXXXXXXXXB
BXXXXXXXXXXXXXXXXXXXXXXXXXXXXXXXXXXXXXXXXXXXXXXXXXXXXXXXXXXXXXXXXXXXXXXXXXXXXXXXXXXXXXFZXXXXXXXXXXXXXXXXXXXXXXXXXXXXXXXB
BXXXXXXXXXXXXXXXXXXXXXXXXXXXXXXXXXXXXXDDVXXXXXXXXZZZZXXXXXXXXXXXXXXXXXXXXXZZZZZZZZZZZZZZXXXXXXXXXXXXXXXXXXXXXXXXXXXXXXXB
BXXXXXXXXXXXXXXXXXXXXXXXXXXXXXXXXXXXZZZZZXXXZZZXXZZZZXXXXXXXXXXXXXXXXXXXXXXXXXXXXXXXXDDVXXXXXXXXXXXXXXXXXXXXXXXXXXXXXXXB
BXXXXXXXXXXXXXXXXXXXXXXXXXXXXXXXXZXXXXXXXXXXXXXXXZZZZXXXXXXXXXXXXXXXXXXXXXXXXXXXXXXXXDDVXXXXXXXXXXXXXXXXXXXXXXXXXLLLXXXB
BXXXXXXXXXXXXXXXXXXXXXXXXXXXXXXXXXXXXXXXXXXXXXXXXZZZZXXXXXXXXXXXXXXXXXXXXZZZZZZZZZZZZZZZXXXXXXXXXXXXXXXXDVDXXXXXXLLLXXXB
BXXXXXXXXXXXXXXXXXXXXXXXZZZXXXZXXXLLLXXXXXTXXXXXXZZZZXXXXXXXXXXXXXXXXXXXXXXXXXXXXXXXXXXKXXXXXXXXXXXXXXXXXXXXXXXXXLLLXXXB
BXXXXXXXXXXXXXXXXXXXXXXXXXXXXXXXXXLLLXXXXXXXXXXXXZZZZXXXXXXXXXXXXXXXXXXXXXXXXXXXXXXXXXXKXXXXXXXXXXXXXXXXXXXXXXXXXXHXXXXB
BXXXXXXXXXXXXXXXXXXXXZZXXXXXXXXXXXLLLXXXXXXXXXXXXZZZZXXXXXXXXXXXXXXXXXXXZZZZZZZZZZZZZZZZXXXXXXXVDDXXXXXXIIIXXXXXXXHXXXXB
BXXXXXXXXXDDVXFXXXXXXXXXXXXXXXXXXXXHXXXXXXXXXXXXxXXXZXXXXXXXXXXXXXXXVDDXXXXXXXXXXXXXXXXXXXXXXXXZXXDVDXXXZZZFXXXXXXHXXXEB
BXXXXXXXZZZZZZZXXXZZZZZZZXXXXXXXXXXHXXXXXXXXXXXXXXXFZXXXZZXXXXXZXXZZZZZZXXXXXXXXXXXXXXXXXZZZZZZZZZZZZZZZZZZZXXXZZZZZZZZB
BZZZZZZZZZZZZZZWWWZZZZZZZZZZZZZZZZZZZZZZZZZZZZZZZZZZZWWWZZZZZZZZWWZZZZZZWWWWWWWWWWWWWWWWWZZZZZZZZZZZZZZZZZZZWWWZZZZZZZZB
