BXXXXXXXXXXXXXXXXXXXXXXXFXXXXXXXXXXXXXXXXXXXXXXXXXXXXXXXXXXXXXXXXXXXXXXXXXXXXXXXIXXXXCXXXXCXXXXXCXXXCXXXXXXXXXXB
BXXXXXXXXXXXXXXXXXXXXXXXXXXXXXXXXXXXXXXXXXXXXXXXXXXXXXXXXXXXXXXXXXXXXXXXXXXXXXXFIXXXXXXXXXXXXXXXXXXXXXXXXXXXXXXB
BXXXXXXXXXXXXXXXXXXXXXXXXXXXXXXXXXDDVXXXXXXXXIIIIXXXXXXXXXXXXXXXXXXXXIIIIIIIIIIIIXXXXXXXXXXXXXXXXXXXXXXXXXXXXXXB
BXXXXXXXXXXXXXXXXXXXXXXXXXXXXXXXIIIIIXXXIIIXXIIIIXXXXXXXXXXXXXXXXXXXXXXXXXXXXXDDVXXXXXXXXXXXXXXXXXXXXXXXXXXXXXXB
BXXXXXXXXXXXXXXXXXXXXXXXXXXXXIXXXXXXXXXXXXXXXIIIIXXXXXXXXXXXXXXXXXXXXXXXXXXXXXDDVXXXXXXXXXXXXXXXXXXXXXXXXXLLLXXB
BXXXXXXXXXXXXXXXXXXXXXXXXXXXXXXXXXXXXXXXXXXXXIIIIXXXXXXXXXXXXXXXXXXXIIIIIIIIIIIIIXXXXXXXXXXXXXXXXDVDXXXXXXLLLXXB
BXXXXXXXXXXXXXXXXXXXIIIXXXIXXXXXXXXXXXTXXXXXXIIIIXXXXXXXXXXXXXXXXIXXXXXXXXXXXXXXKXXXXXXXXXXXXXXXXXXXXXXXXXLLLXXB
BXXXXXXXXXXXXXXXXXXXXXXXXXXXXXXXXXXXXXXXXXXXXIIIIXXXXXXXXXXXXXXXXXXXXXXXXXXXXXXXKXXXXXXXXXXXXXXXXXXXXXXXXXXHXXXB
BXXXXXXXXXXXXXXXXIIXXXXXXXXXXXXXXXXXXXXXXXXXXIIIIXXXXXXXXXXXXXXXXXXXIIIIIIIIIIIIIXXXXXXXVDDXXXXXXIIIXXXXXXXHXXXB
IBXXXXXDDVXFXXXXXXXXXXXXXXXXXXXXXXXXXXXXXXXXXXXXIXXXXXXXXXXXXXXXVDDXXXXXXXXXXXXXXXXXXXXXIXXDVDXXXIIIFXXXXXXHXXXB
BXXXIIIIIIIXXXIIXXXXXXXXXXXXXXXXXXXXXXXXXXXXXXXFIXXXIIXXXXXIXXIIIIIIXXXXXXXXXXXXXXIIIIIIIIIIIIIIIIIIIXXXIIIIIIIB
BIIIIIIIIIIWWWIIIIIIIIIIIIIIIIIIIIIIIIIIIIIIIIIIIWWWIIIIIIIIWWIIIIIIWWWWWWWWWWWWWWIIIIIIIIIIIIIIIIIIIWWWIIIIIIIB
