BXXXXXXXXXXXXXXXXXXXXXXXXCXXXXXXXXXXXXXXXXXXXXXXXXXXXCXXXXXXXCXXXXXXXXXXXXXXXXQQQQQXXXXXCXXXXXXXXXXXXXXXCXXXXXXXXXXXB
BXXXXXXXXXXXXXXXXXXXXXXXXXXXXXXXXXXXXXXXXXXXXXXXXXXXXXXXXXXXXXXXXXXXXXXXXXXXXXXXXXXXXXXXXXXXXXXXXXXXXXXXXXXXXXXXXXXXB
BXXXXXXXXXXXXXXXXXXXXXXXXXXXXXXXXXXXXXXXXXXXXXXXXXLLLXXXXXXXXXXXXXXXXXXXXXXXXXXXXXXXXXXXXXXXXXXXXXXXXXXXXXXXXXXXXXXXB
BXXXLLLXXXXXXXXXFXXXXXXXXXXXXXXXXXOOXXKXXOOXXXXXXXLLLXXXXXXXXXXXXXXXXXXXXXXXXXXXXXXXXXXXXXXXXXXXXXXXXXXXXXXXXXXXXXXXB
BXXXLLLXXXXXXXXOOOOXXXXXXXXXXXXXOXXXXXXXXXXKXXXXXXLLLXXXXXXXXXXXXLLLXXXXXXXFXXXXXXXXXXXXXXXXXXXXXXXXXXOXXXXXXXXXXXXXB
BXXXLLLXXXXXXXXXXXXXXXXXXXXXXXOXXXXXXXXXXXXXKXXXXXXHXXXXXXXXXXXXXLLLXXXXXXXKXXXXXXXXXXXXXXXXXXXXXXXXOXXXXXXXXXXXXXXXB
BXXXXHXXXXXXXXXXXXXXXXOOXXXOOXXXXXXXXXXXXXXXXKXXXXXHXXXXXXXXXXFXXLLLXXXXXKXXXXKKKKKXXXXXXXDDVXXXXXXXXXXXXXXXXXXXXXXXB
BXXXXHXXXXXXXXXXXXXXXXXXXXXXXXXXXXXXXXXXXXXXXXXXXXXHXXXXXXXXXXOXXXHXXXXKXXXXXXXXXXXXXXXXXOOOOXKXOMOXXXXXXXXXXXXXXXXXB
BXXXXHXXXXXXXXXXXXXDVDXXXXXXXXXXXXXXXXXXXXXXXXXXXFXHXXXOOOOOXXOXXXHXXXXXXXXXXXXXXXXXXXXXXXXXXXXXXOXXXXXXXXXXXXXXXXXEB
BOXXXHXXXXXXXXXXOOXOOXXXXXXXXXXXXXXXXXXXXXXXXXXXOOOOOOOOOOOOXXOXXXHXXKXXXXXXXXXXXXXXXXOOXXXXXXXXXXXXXXXXXXXXXXXXXXOOB
BOOXXHXXOXXOXMXOOOWOOOXXXXXXXXXXXXXXXXXXXXXXXXOOOOOOOOOOOOOOXXXMXXHXXXXXDVDXOOOOOOOOOXXXXXXXXXXXXXXXXXXXOXXMXXMXXOOOB
BOOOOOOOOWWOOOOOOOWOOOOWWWWWWWWWWWWWWWWWWWWWWOOOOOOOOOOOOOOOOOOOOOOOOOOOOOOOOOOOOOOOOWWWWWWWWWWWWWWWWWWWOOOOOOOOOOOOB