BGGGGGGGGGGGGGGGGGGGGGGGGGGCGGGGGGGGGGGGCGGGGGGGGGGCGGGGGGGGGGGGGGGGGGGGGGGGGCGGGGGXXXXXXXXDVCGGGGGGGGGCGGGGGGGCGGCGCGGGGGGGGGGGB
BGXXXXXXXXXXXXXXGGGGGGGGXXXXXXXXXXXXXXXXXXXXXXXXXXXXXXXXXXXXXGGXXXXXXXXXXXXXXXXXXXXXXXXXXXXXXXXXXXXXXXXXXXXXXXXXXXXXXXXXXXGGGGGGB
BXXXXXXXXXXXXXXXXGGGGGXXXXXXXXXXXXXXXXXXXXXXXXXXXXXXXXXXXXXXXXXXXXXXXXXXXXXXXXXXXXXXXXXXXXXXXXXXXXXXXXXXXXXXXXXXXXXXXXXXXXXXXXGGB
BXXXXXXXXXXXXXXXXXXXXXXXXXXXXXXXXXXXXXXXXXXXXXXXXXXXXXXXXXXXXXXXXXXXXXXXXXXXXXXXXXXXXGXXGGXXXXXXXXXXGGGXXXXXXXXXXXXXXXXXXXXXXXXGB
BXXXXXXXXXXXXXXXXXXXXXXXXXXXXXXXXXXXXXXXGXXXXXXXXXXXXXXXXXXXXXXXXXXXXXXXXXXXXXXXXXXXXXXXXXXXXXXXXXXXXXXXXXXXXXXXXXXXXXXXXXXXXXXXB
BXXXXXXXXXXXXXXXXXXXXXXXXXXXXXXXXXXXXXGXXXXXXXXXXXXXXXKXXXXXXXXXXXXXGGPPXXXGGXXXXXXGXXXXXGGGXXXGGGXXXXXXXXXXXXXGGKKKKKGGXXXXXXXXB
BXXXXXXXXKXXXXXXXXXXXXXXXXXXXXXXXXXXGXXXXXXXXXXXGGXXXGGXXXXXXXXXXFXXXXXXXXXXXXXXXXXXXXXXXXXXXXXXXXXXXXXVDXMXVDDXXXXXXXXXXXXXXXXXB
BXXXXXXXXKXXXXXXXXXXXXXXXXXXXXXXXXGXXXXXGXXMXXGXXXXXXXXXXXXXXXXXGGGXXXXXXXXXXXXXXXXXXXXXXXXXXXXXXXXXXXXGGGGGGXXXXXXXXXXXXXXXXXXXB
BXXXXXXXXKXXXXXXXXXXXXXXXXXXXXXXXXXXXXXXGGGGGGGXXXXXXXXGGGPPXXXXGGGXXXXXXXXXXXXXGGGXXXXXXXXXXXXXXXXXXXXXXXXXXXXXXXXXXXXXXXXXFXXEB
BXXXXXXXGGGXXGGXXXXXXXXXXDDVDDFGGXXXXXXXXXXXXXXXXXXXXXXGGGXXXXXXGGGXXXXXXXXXXXXXXXXXXXXXXXXXXXXXXXXXXXXXXXXXXXXXXXXXXXXXXXXXKXXXB
BGXXXXGGGGGWWGGGXXXXXXXMGGGGGGGGGXXXXXXXXXXXXXXXXXXXXXXGGGXXXXXXGGGXXXXXXXXXXGGXXXXXXXXXXXXXXXXXXXXXXXXXXXXXXXXXXXXXXXXXGGGGGGGGB
BGGGGGGGGGGUUGGGGGGGGGGGGGGGGGGGGWWWWWWWWWWWWWWWWWWWWWWGGGGGGGGGGGGWWWWWWWWWWGGWWWWWWWWWWWWWWWWWWWWWWWWWWWWWWWWWWWWWWWWWGGGGGGGGB