BXXXXXXXXXXXXXXXXXXXXXXXXXXXXXXXXXXXXXXXXXXXXXXXXXXXXXXXXXXXXXXXXXXXXXXXXXXXXXXXXXXXXXXXXXXXXXXXXXXXXXXXXXXXXQQQQQXXXXXXXXXXXXXXXXXXXXXXB
BXXXXXXXXXXXXXXXXXXXXXXXXXXXXXXXXXXXXXXXXXXXXXXXXXXXXXXXXXXXXXXXXXXXXXXXXXXXXXXXXXXXXXXXXXXXXXXXXXXXXXXXXXXXXXXXXXXXXXXXXXXXXXXXXXXXXXXXB
BXXXXXXXXXXXXXXXXXXXXXXXXXXXXXXXXXXXXXXXXXXXXXXXXXXXXXXXXXXXXXXXXXXXXXXXXXXXXXXXXXXXXXXXXXXXXXXXXXXXXXXXXXXXXXXXXXXXXXXXXXXXXXXXXXXXXXXXB
BXXXXXXXXXXXXXXXXXXXXXXXXXXXXXXXXXXXXXXXXXXXXXXXXXXXXXXXXXXXXXXXXXXXXXXXXXXXXXXXXXXXXXXXXXXXXXXXXXXXXXXXXXXXXXXXXXXXXXXXXXXXXXXXXXXXXXXXB
BXXXXXXXXXXXXXXXXXXXXXXXXXXXXXXXXXXXXXXXXXXXXXXXXXXXXXXXXXXXXXXXXXXXXXXXXXXXXXXXXXXXXXXXXXXXXXXXXXXXXXXXXXXXXXXXXXXXXXXXXXXXXXXXXXXXXXXXB
BXXXXXXXXXXXXXXXXXXXXXXXXXXXXXXXXXXXXXXXXXXXXXXXXXXXXXXXXXXXXXXXXXXXXXXXXXXXXXXXXXXXXXXXXXXXXXXXXXXXXXXXXXXXXXXXXXXXXXXXXXXXXXXXXXXXXXXXB
BXXXXXXXXXXXXXXXXXXXXXXXXXXXXXXXXXXXXXXXXXXXXXXXXXXXXXXXXXXXXXXXXXXXXXXXXXXXXXXXXXXXXXXXXXXXXXXXXXXXXXXXXXXXXXXXXXXXXXXXXXXXXXXXXXXXXXXXB
BXXXXXXXXXXXXXXXXXXXXXXXXXXXXXXXXXXXXXXXXXXXXXXXSSXXXSSSXXXXXXXXXXXXXXXXXXXXXXXXXXXXXXXXXXXXXXXXSXXXSXXXXXXXSSSSSSSXXXXXXXXXXXXXXXXXXXXXB
BXXXXXXXXXXXXXXXXXXXXXXXXXXXXSSSXXXXXXXXXXXXXXSSSSXXXSSSXXXXXXXXXXXXXXXXXXXXXXXXXXXXXXXXXKXXXXXSSWWWSSXXXXXXXKXXXXXXXXXXXXXXXXXSSSXXFXXEB
BXXXXXXXXXXXXXXXXXXXSSSXXXXXXSSSXXXXXXXXXXXXSSSSSSXXXSSSXXXXXXXXXXXXXXXXXXXXXXXSSSSXXXXXXKXXXXSSSUUUSSSXXFXXXKXXXXXXXXXXXXXXXSSSSSSSSXXXB
BXXSSSSSSSSSSXXXXXXXSSSXXXXXXSSSXXXXSSSXXXSSSSSSSSWWWSSSXXXXXSSSXXSSSXXSSSXXSSSSSSSSXXXXXKXXFSSSSUUUSSSSSSSSSSSSSSSSSSXXXSSSSSSSSSSSSSSSB
BWWSSSSSSSSSSSSSSSSSSSSSSSSSSSSSSSSSSSSSSSSSSSSSSSUUUSSSSSSSSSSSWWSSSWWSSSWWSSSSSSSSSSSSSSSSSSSSSUUUSSSSSSSSSSSSSSSSSSWWWSSSSSSSSSSSSSSSB
