BXXXXXXXXXXXXXXXXXXXXXXXXCXXXXXXXXXXXXXXXXXXXXXXXXXXXCXXXXXXXCXXXXXXXXXXXXXXXXXQQQQQXXXXXCXXXXXXXXXXXXXXXCXXXXXXXXXXXB
BXXXXXXXXXXXXXXXXXXXXXXXXXXXXXXXXXXXXXXXXXXXXXXXXXXXXXXXXXXXXXXXXXXXXXXXXXXXXXXXXXXXXXXXXXXXXXXXXXXXXXXXXXXXXXXXXXXXXB
BXXXXXXXXXXXXXXXXXXXXXXXXXXXXXXXXXXXXXXXXXXXXXXXXXLLLXXXXXXXXXXXXXXXXXXXXXXXXXXXXXXXXXXXXXXXXXXXXXXXXXXXXXXXXXXXXXXXXB
BXXXLLLXXXXXXXXXFXXXXXXXXXXXXXXXXXOOXXKXXOOXXXXXXXLLLXXXXXXXXXXXXXXXXXXXXXXXXXXXXXXXXXXXXXXXXXXXXXXXXXXXXXXXXXXXXXXXXB
BXXXLLLXXXXXXXXOOOOXXXXXXXXXXXXXOXXXXXXXXXXKXXXXXXLLLXXXXXXXXXXXXLLLXXXXXXXXFXXXXXXXXXXXXXXXXXXXXXXXXXXOXXXXXXXXXXXXXB
BXXXLLLXXXXXXXXXXXXXXXXXXXXXXXOXXXXXXXXXXXXXKXXXXXXHXXXXXXXXXXXXXLLLXXXXXXXXKXXXXXXXXXXXXXXXXXXXXXXXXOXXXXXXXXXXXXXXXB
BXXXXHXXXXXXXXXXXXXXXXOOXXXOOXXXXXXXXXXXXXXXXKXXXXXHXXXXXXXXXXFXXLLLXXXXXXKXXXXKKKKKXXXXXXXDDVXXXXXXXXXXXXXXXXXXXXXXXB
BXXXXHXXXXXXXXXXXXXXXXXXXXXXXXXXXXXXXXXXXXXXXXXXXXXHXXXXXXXXXXOXXXHXXXXXKXXXXXXXXXXXXXXXXXOOOOXKXOMOXXXXXXXXXXXXXXXXXB
BXXXXHXXXXXXXXXXXXXDVDXXXXXXXXXXXXXXXXXXXXXXXXXXXFXHXXXOOOOOXXOXXXHXXXXXXXXXXXXXXXXXXXXXXXXXXXXXXXOXXXXXXXXXXXXXXXXXEB
BOXXXHXXXXXXXXXXOOXOOXXXXXXXXXXXXXXXXXXXXXXXXXXXOOOOOOOOOOOOXXOXXXHXXXKXXXXXXXXXXXXXXXXOOXXXXXXXXXXXXXXXXXXXXXXXXXXOOB
BOOXXHXXOXXOXMXOOOWOOOXXXXXXXXXXXXXXXXXXXXXXXXOOOOOOOOOOOOOOXXXMXXHXXXXXXDVDXOOOOOOOOOXXXXXXXXXXXXXXXXXXXOXXMXXMXXOOOB
BOOOOOOOOWWOOOOOOOWOOOOWWWWWWWWWWWWWWWWWWWWWWOOOOOOOOOOOOOOOOOOOOOOOOOOOOOOOOOOOOOOOOOWWWWWWWWWWWWWWWWWWWOOOOOOOOOOOOB