BXXXXXXXXXXXXXXXXXXXXXXXXXXXXFXXXXXXXXXXXXXXXXXXXXXXXXXXXXXXXXXXXXXXXXXXXXXXXXXXXXXXXXXXXXXXZXXXXCXXXXCXXXXXCXXXCXXXXXXXXXXXXB
BXXXXXXXXXXXXXXXXXXXXXXXXXXXXXXXXXXXXXXXXXXXXXXXXXXXXXXXXXXXXXXXXXXXXXXXXXXXXXXXXXXXXXXXXXXFZXXXXXXXXXXXXXXXXXXXXXXXXXXXXXXXXB
BXXXXXXXXXXXXXXXXXXXXXXXXXXXXXXXXXXXXXXDDVXXXXXXXXZZZZZXXXXXXXXXXXXXXXXXXXXXXZZZZZZZZZZZZZZZZXXXXXXXXXXXXXXXXXXXXXXXXXXXXXXXXB
BXXXXXXXXXXXXXXXXXXXXXXXXXXXXXXXXXXXXZZZZZXXXZZZXXZZZZZXXXXXXXXXXXXXXXXXXXXXXXXXXXXXXXXXXXDDVXXXXXXXXXXXXXXXXXXXXXXXXXXXXXXXXB
BXXXXXXXXXXXXXXXXXXXXXXXXXXXXXXXXXZXXXXXXXXXXXXXXXZZZZZXXXXXXXXXXXXXXXXXXXXXXXXXXXXXXXXXXXDDVXXXXXXXXXXXXXXXXDVDXXXXXXLLLXXXXB
BXXXXXXXXXXXXXXXXXXXXXXXXXXXXXXXXXXXXXXXXXXXXXXXXXZZZZZXXXXXXXXXXXXXXXXXXXXXZZZZZZZZZZZZZZZZZXXXXXXXXXXXXXXXXXXXXXXXXXLLLXXXXB
BXXXXXXXXXXXXXXXXXXXXXXXXZZZXXXZXXXLLLXXXXXTXXXXXXZZZZZXXXXXXXXXXXXXXXXXXXXXXXXXXXXXXXXXXXXXKXXXXXXXXXXXXXXXXXXXXXXXXXLLLXXXXB
BXXXXXXXXXXXXXXXXXXXXXXXXXXXXXXXXXXLLLXXXXXXXXXXXXZZZZZXXXXXXXXXXXXXXXXXXXXXXXXXXXXXXXXXXXXXKXXXXXXXXXXXXXXXXXXXXXXXXXXHXXXXXB
BXXXXXXXXXXXXXXXXXXXXXZZXXXXXXXXXXXLLLXXXXXXXXXXXXZZZZZXXXXXXXXXXXXXXXXXXXXZZZZZZZZZZZZZZZZZZXXXXXXXVDDXXXXXXZZZXXXXXXXHXXXXEB
BXXXXXXXXXXXDVXFXXXXXXXXXXXXXXXXXXXXHXXXXXXXXXXXXxXXXZZXXXXXXXXXXXXXXXVDDXXXXXXXXXXXXXXXXXXXXXXXXXXXZXXDVDXXXZZZFXXXXXXHXXXXXB
BXXXXXXXZZZZZZZZXXXZZZZZZZXXXXXXXXXXHXXXXXXXXXXXXXXXFZZXXXZZXXXXXZXXZZZZZZXXXXXXXXXXXXXXXXXXXXZZZZZZZZZZZZZZZZZZZXXXZZZZZZZZZB
BZZZZZZZZZZZZZZZWWWZZZZZZZZZZZZZZZZZZZZZZZZZZZZZZZZZZZZWWWZZZZZZZZWWZZZZZZWWWWWWWWWWWWWWWWWWWWZZZZZZZZZZZZZZZZZZZWWWZZZZZZZZZB
