BXXXXXXXXXXXXCXXXXXXXXXXXXXXXXXX
BXXXXXXXXXXXXXXXXXXXXXXXXXXXXXXX
BXXXXXXXXXXXXXXXXXXXXXXXXXXXXXXX
BXXXXXXXXXXXXXXXXXXXXXXXXXXXXXXX
BXXXXXXXXXXXXXXXXXXXXXXXXXXXXXXX
BXXXXXXXXXXXXXXXXXXXXXXXXXXXXXXX
BXXXXXXXXFXXXXXXXXXXXXXXXXXXXXXX
BXXXXXXXXXXXXXXXXXXXXXXXXXXXXXXX
BXXXXXXXXXXXXXXXXXXXXXXXXXXXXXXX
BXXXXXKXXXXXXXXXXXXXXGXXMXXXXXGG
BXXXGGGGGGGGGGGXXXXGGGGGGGGGGGGG
BGGGGGGGGGGGGGGWWWWGGGGGGGGGGGGG
