BXXXXXXXXXXXXXXXXXXXXXXXXXXXFXXXXXXXXXXXXXXXXXXXXXXXXXXXXXXXXXXXXXXXXXXXXXXXXXXXXXXXIXXXXCXXXXCXXXXXCXXXCXXXXXXXXXXB
BXXXXXXXXXXXXXXXXXXXXXXXXXXXXXXXXXXXXXXXXXXXXXXXXXXXXXXXXXXXXXXXXXXXXXXXXXXXXXXXXXXFIXXXXXXXXXXXXXXXXXXXXXXXXXXXXXXB
BXXXXXXXXXXXXXXXXXXXXXXXXXXXXXXXXXXXXXDDVXXXXXXXXIIIIXXXXXXXXXXXXXXXXXXXXXIIIIIIIIIIIXXXXXXXXXXXXXXXXXXXXXXXXXXXXXXB
BXXXXXXXXXXXXXXXXXXXXXXXXXXXXXXXXXXXIIIIIXXXIIIXXIIIIXXXXXXXXXXXXXXXXXXXXXXXXXXXXXDDVXXXXXXXXXXXXXXXXXXXXXXXXXXXXXXB
BXXXXXXXXXXXXXXXXXXXXXXXXXXXXXXXXIXXXXXXXXXXXXXXXIIIIXXXXXXXXXXXXXXXXXXXXXXXXXXXXXDDVXXXXXXXXXXXXXXXXXXXXXXXXXLLLXXB
BXXXXXXXXXXXXXXXXXXXXXXXXXXXXXXXXXXXXXXXXXXXXXXXXIIIIXXXXXXXXXXXXXXXXXXXXIIIIIIIIIIIIXXXXXXXXXXXXXXXXDVDXXXXXXLLLXXB
BXXXXXXXXXXXXXXXXXXXXXXXIIIXXXIXXXLLLXXXXXTXXXXXXIIIIXXXXXXXXXXXXXXXXXXXXXXXXXXXXXXXKXXXXXXXXXXXXXXXXXXXXXXXXXLLLXXB
BXXXXXXXXXXXXXXXXXXXXXXXXXXXXXXXXXLLLXXXXXXXXXXXXIIIIXXXXXXXXXXXXXXXXXXXXXXXXXXXXXXXKXXXXXXXXXXXXXXXXXXXXXXXXXXHXXXB
BXXXXXXXXXXXXXXXXXXXXIIXXXXXXXXXXXLLLXXXXXXXXXXXXIIIIXXXXXXXXXXXXXXXXXXXIIIIIIIIIIIIIXXXXXXXVDDXXXXXXIIIXXXXXXXHXXXB
BXXXXXXXXXDDVXFXXXXXXXXXXXXXXXXXXXXHXXXXXXXXXXXXxXXXIXXXXXXXXXXXXXXXVDDXXXXXXXXXXXXXXXXXXXXXIXXDVDXXXIIIFXXXXXXHXXEB
BXXXXXXXIIIIIIIXXXIIIIIIIXXXXXXXXXXHXXXXXXXXXXXXXXXFIXXXIIXXXXXIXXIIIIIIXXXXXXXXXXXXXXIIIIIIIIIIIIIIIIIIIXXXIIIIIIIB
BIIIIIIIIIIIIIIWWWIIIIIIIIIIIIIIIIIIIIIIIIIIIIIIIIIIIWWWIIIIIIIIWWIIIIIIWWWWWWWWWWWWWWIIIIIIIIIIIIIIIIIIIWWWIIIIIIIB
