BGGGGGGGGGGGGGGGGGGGGGGGCGGGGGGGGGGGGCGGGGGGGGGGCGGGGGGGGGGGGGGGGGGGGGGGGGCGGGGGXXXXXXXDDVCGGGGGGGGCGGGGGGGCGGGGGGGGB
BGXXXXXXXXXXXXXGGGGGGGGXXXXXXXXXXXXXXXXXXXXXXXXXXXXXXXXXXXGGXXXXXXXXXXXXXXXXXXXXXXXXXXXXXXXXXXXXXXXXXXXXXXXXXXGGGGGGB
BXXXXXXXXXXXXXXXGGGGGXXXXXXXXXXXXXXXXXXXXXXXXXXXXXXXXXXXXXXXXXXXXXXXXXXXXXXXXXXXXXXXXXXXXXXXXXXXXXXXXXXXXXXXXXXXXXGGB
BXXXXXXXXXXXXXXXXXXXXXXXXXXXXXXXXXXXXXXXXXXXXXXXXXXXXXXXXXXXXXXXXXXXXXXXXXXXXXXXXXGXXGGXXXXXXXXXXGGXXXXXXXXXXXXXXXXXB
BXXXXXXXXXXXXXXXXXXXXXXXXXXXXXXXXXXXXGXXXXXXXXXXXXXXXXXXXXXXXXXXXXXXXXXXXXXXXXXXXXXXXXXXXXXXXXXXXXXXXXXXXXXXXXXXXXXXB
BXXXXXXXXXXXXXXXXXXXXXXXXXXXXXXXXXXGXXXXXXXXXXXXXXXKXXXXXXXXXXXXXGGPPXXXGGXXXXXXGXXXXXGGGXXXGGGXXXXXXXXXXXXXXXXXXXXXB
BXXXXXXXKXXXXXXXXXXXXXXXXXXXXXXXXGXXXXXXXXXXXGGXXXGGXXXXXXXXXXFXXXXXXXXXXXXXXXXXXXXXXXXXXXXXXXXXXXXVDXMXVDDXXXXXXXXXB
BXXXXXXXKXXXXXXXXXXXXXXXXXXXXXXGXXXXXGXXMXXGXXXXXXXXXXXXXXXXXGGGXXXXXXXXXXXXXXXXXXXXXXXXXXXXXXXXXXXGGGGGGXXXXXXXXXXXB
BXXXXXXXKXXXXXXXXXXXXXXXXXXXXXXXXXXXXGGGGGGGXXXXXXXXGGGPPXXXXGGGXXXXXXXXXXXXXGGGXXXXXXXXXXXXXXXXXXXXXXXXXXXXXXXXFXXXB
BXXXXXXGGGXXXXXXXXXXXXDDVDDFGGXXXXXXXXXXXXXXXXXXXXXXGGGXXXXXXGGGXXXXXXXXXXXXXXXXXXXXXXXXXXXXXXXXXXXXXXXXXXXXXXXXKXXEB
BGXXXXGGGGXXGGGXXXXXMGGGGGGGGGXXXXXXXXXXXXXXXXXXXXXXGGGXXXXXXGGGXXXXXXXXXXGGXXXXXXXXXXXXXXXXXXXXXXXXXXXXXXXXGGGGGGGGB
BGGGGGGGGGWWGGGGGGGGGGGGGGGGGGWWWWWWWWWWWWWWWWWWWWWWGGGGGGGGGGGGWWWWWWWWWWGGWWWWWWWWWWWWWWWWWWWWWWWWWWWWWWWWGGGGGGGGB