BGGGGGGGGGGGGGGGGGGGGGGGGGGCGGGGGGGGGGGGCGGGGGGGGGGCGGGGGGGGGGGGGGGGGGGGGGGGGGCGGGGGXXXXXXXXDVCGGGGGGGGGCGGGGGGGCGGCGCGGGGGGGGGGGGGGGGGGCGGGGGGGGGGGB
BGXXXXXXXXXXXXXXGGGGGGGGXXXXXXXXXXXXXXXXXXXXXXXXXXXXXXXXXXXXXGGXXXXXXXXXXXXXXXXXXXXXXXXXXXXXXXXXXXXXXXXXXXXXXXXXXXXXXXXXXXXXXXXXXXXXXXXXXXXXXXGGGGGGB
BXXXXXXXXXXXXXXXXGGGGGXXXXXXXXXXXXXXXXXXXXXXXXXXXXXXXXXXXXXXXXXXXXXXXXXXXXXXXXXXXXXXXXXXXXXXXXXXXXXXXXXXXXXXXXXXXXXXXXXXXXXXXXXXXXXXXXXXXXXXXXXXXXGGB
BXXXXXXXXXXXXXXXXXXXXXXXXXXXXXXXXXXXXXXXXXXXXXXXXXXXXXXXXXXXXXXXXXXXXXXXXXXXXXXXXXXXXXGXXGGXXXXXXXXXXGGGXXXXXXXXXXXXXXXXXXXXXXXXXXXXXXXXXXXXXXXXXXXGB
BXXXXXXXXXXXXXXXXXXXXXXXXXXXXXXXXXXXXXXXGXXXXXXXXXXXXXXXXXXXXXXXXXXXXXXXXXXXXXXXXXXXXXXXXXXXXXXXXXXXXXXXXXXXXXXXXXXXXXXXXXXXXXXXXXXXXFXXXXXXXXXXXXXXB
BXXXXXXXXXXXXXXXXXXXXXXXXXXXXXXXXXXXXXGXXXXXXXXXXXXXXXKXXXXXXXXXXXXXGGPPXXXXGGXXXXXXGXXXXXGGGXXXGGGXXXXXXXXXXXXXGGKKKKKGGXXXXXXXXXXXXKXXXXXXXXXXXXXXB
BXXXXXXXXKXXXXXXXXXXXXXXXXXXXXXXXXXXGXXXXXXXXXXXGGXXXGGXXXXXXXXXXFXXXXXXXXXXXXXXXXXXXXXXXXXXXXXXXXXXXXXXVDXMXVDDXXXXXXXXXXXXXXXXXXXKXXXXGGGXXXXXXXXXB
BXXXXXXXXKXXXXXXXXXXXXXXXXXXXXXXXXGXXXXXGXXMXXGXXXXXXXXXXXXXXXXXGGGXXXXXXXXXXXXXXXXXXXXXXXXXXXXXXXXXXXXXGGGGGGXXXXXXXXXXXXXXXXXXXKXXXXXXXXXXXXXXXXXXB
BXXXXXXXXKXXXXXXXXXXXXXXXXXXXXXXXXXXXXXXGGGGGGGXXXXXXXXGGGPPXXXXGGGXXXXXXXXXXXXXXGGGXXXXXXXXXXXXXXXXXXXXXXXXXXXXXXXXXXXXXXXXXXXKXXXXXXXXXXXXXXXXXXXEB
BXXXXXXXGGGXXGGXXXXXXXXXXDDVDDFGGXXXXXXXXXXXXXXXXXXXXXXGGGXXXXXXGGGXXXXXXXXXXXXXXXXXXXXXXXXXXXXXXXXXXXXXXXXXXXXXXXXXXXXXXXXXXKXXXXXXXXXXXXXXXXXXXXXXB
BGXXXXGGGGGWWGGGXXXXXXXMGGGGGGGGGXXXXXXXXXXXXXXXXXXXXXXGGGXXXXXXGGGXXXXXXXXXXXGGXXXXXXXXXXXXXXXXXXXXXXXXXXXXXXXXXXXXXXXXXGGGGGGXXXXXXXXXXXXGGGGGGGGGB
BGGGGGGGGGGUUGGGGGGGGGGGGGGGGGGGGWWWWWWWWWWWWWWWWWWWWWWGGGGGGGGGGGGWWWWWWWWWWWGGWWWWWWWWWWWWWWWWWWWWWWWWWWWWWWWWWWWWWWWWWGGGGGGWWWWWWWWWWWWGGGGGGGGGB