BXXXXXXXXXXXXXXXXXXXXXXXXXXXXFXXXXXXXXXXXXXXXXXXXXXXXXXXXXXXXXXXXXXXXXXXXXXXXXXXXXXXXXXXXXXZXXXXCXXXXCXXXXXCXXXCXXXXXXXXXXXXB
BXXXXXXXXXXXXXXXXXXXXXXXXXXXXXXXXXXXXXXXXXXXXXXXXXXXXXXXXXXXXXXXXXXXXXXXXXXXXXXXXXXXXXXXXXFZXXXXXXXXXXXXXXXXXXXXXXXXXXXXXXXXB
BXXXXXXXXXXXXXXXXXXXXXXXXXXXXXXXXXXXXXXDDVXXXXXXXXZZZZZXXXXXXXXXXXXXXXXXXXXXZZZZZZZZZZZZZZZZXXXXXXXXXXXXXXXXXXXXXXXXXXXXXXXXB
BXXXXXXXXXXXXXXXXXXXXXXXXXXXXXXXXXXXXZZZZZXXXZZZXXZZZZZXXXXXXXXXXXXXXXXXXXXXXXXXXXXXXXXXXDDVXXXXXXXXXXXXXXXXXXXXXXXXXXXXXXXXB
BXXXXXXXXXXXXXXXXXXXXXXXXXXXXXXXXXZXXXXXXXXXXXXXXXZZZZZXXXXXXXXXXXXXXXXXXXXXXXXXXXXXXXXXXDDVXXXXXXXXXXXXXXXXDVDXXXXXXLLLXXXXB
BXXXXXXXXXXXXXXXXXXXXXXXXXXXXXXXXXXXXXXXXXXXXXXXXXZZZZZXXXXXXXXXXXXXXXXXXXXZZZZZZZZZZZZZZZZZXXXXXXXXXXXXXXXXXXXXXXXXXLLLXXXXB
BXXXXXXXXXXXXXXXXXXXXXXXXZZZXXXZXXXLLLXXXXXTXXXXXXZZZZZXXXXXXXXXXXXXXXXXXXXXXXXXXXXXXXXXXXXKXXXXXXXXXXXXXXXXXXXXXXXXXLLLXXXXB
BXXXXXXXXXXXXXXXXXXXXXXXXXXXXXXXXXXLLLXXXXXXXXXXXXZZZZZXXXXXXXXXXXXXXXXXXXXXXXXXXXXXXXXXXXXKXXXXXXXXXXXXXXXXXXXXXXXXXXHXXXXXB
BXXXXXXXXXXXXXXXXXXXXXZZXXXXXXXXXXXLLLXXXXXXXXXXXXZZZZZXXXXXXXXXXXXXXXXXXXZZZZZZZZZZZZZZZZZZXXXXXXXVDDXXXXXXZZZXXXXXXXHXXXXEB
BXXXXXXXXXXXDVXFXXXXXXXXXXXXXXXXXXXXHXXXXXXXXXXXXxXXXZZXXXXXXXXXXXXXXXVDDXXXXXXXXXXXXXXXXXXXXXXXXXXZXXDVDXXXZZZFXXXXXXHXXXXXB
BXXXXXXXZZZZZZZZXXXZZZZZZZXXXXXXXXXXHXXXXXXXXXXXXXXXFZZXXXZZXXXXXZXXZZZZZZXXXXXXXXXXXXXXXXXXXZZZZZZZZZZZZZZZZZZZXXXZZZZZZZZZB
BZZZZZZZZZZZZZZZWWWZZZZZZZZZZZZZZZZZZZZZZZZZZZZZZZZZZZZWWWZZZZZZZZWWZZZZZZWWWWWWWWWWWWWWWWWWWZZZZZZZZZZZZZZZZZZZWWWZZZZZZZZZB
