BXXXXXXXXXXXXXXXXXXXXXXLLLXXXXXXXXXXXXXXXXXXXXXXXXXXXXXXXXXXXXXXXXXXXXXXXXXXXXXXXXXXXXXXXXXXXXXXXXXXXXXCXXXCXXXCXXXCXXXCXXXCXXXCXXXXXXXXXXXXXXXXXXXXXXB
BXXXXXXXXXXXXXXXXXXXXXXLLLXXXXXXXXXXXXXXXXXXXXXXXXXXXXXXXXXXXXXXXXXXXXXXXXXXXXXXXXXXXXXXXXXXXXXXXXXXXXXXXXXXXXXXXXXXXXXXXXXXXXXXXXXXXXXXXXXXXXXXXXXXXXB
BXXXXXXXXXXXXXXXXXXXXXXLLLXXXXXXXXXXXXXXXXXXXXXXXXXXXXXXXXXXXXXXXXXXXXXXXXXXXXXXXXXXXXXXXXXXXXXXXXXXXXXXXXXXXXXXXXXXXXXXXXXXXXXXXXXXXXXXXXXXXXXXXXXXXXB
BXXXXXXXXXXXXXXXXXXXXXXXHXXXXXXXXXXXXXXXXXXXXXXXXXXXXXXXXXXXXXXXXXXXXXXXXXXXXXXXXXXXXXXXXXXXXXXIIIXXXXXXXXXXXXXXXXXXXXXXXXXXXXXXXXXXXXXXXXXXXXXXXXXXXXB
BXXXXXXXXXXXXXXXXXXXXXXXHXXXXXXXXXXXXXXXXXXXXXXXXXXXXIIIIXXXXXXXXXXXXXXXXXXXXXXXXIIKKKIIXXXIIXXXXXXXXXXXXXXXXXXXXXXXXXXXXXXXXXXXXXXXXXXXXLLLXXXXXXXXXXB
BXXXXXXXXXXXXXXXXXXXXXXXHXXXXXXXXXXXXXXXXXXXXXXXXXXXXJJJJXXXXXXXXXXXXXXXXXXXXXXXXXXXXXXXXXXXXXXXXXXXXXXXXXXXXXXXXXXXXXXXXXXXXXXXXXXXXXXXXLLLXXXXXXXXXXB
BXXXXXXXXXXXXXXXXXXXXXIIJIIXXXXXXXXXXXFXXXXXXXXXXXXXXJJJJXXXXXXXXXXXXXXXXXXXXXIIXXXXXXXXXXXXXXXXXXXXXXXXXXXXXXXXXXXXXXXXXXXXIIIXXXXXXXXXXLLLXXXXXXXXXXB
BXXXXXXXXXXXXXXXXXXXXIJJJJJIXXXXXXXXXXIXXXXXXXXXXXXXIJJJXXXXXXXXXXKXXXXXXXXXXXXXXXXXXXXXXXXXXXXXXXXXXXXXXXXXFXXXXXXXXXXXXXXXJJJXXXXXXXXXXXHXXXXXXXXXXXB
BXXXXXXXXXXXXXXXXXXXIJJJJJJJIXXXXXXXXXXXXXXXXXXXXXXXJJJJXXXXXXXXXKKKXXXXXXIIIXXXXXXXFXXXXXXXXXXXXXXXXXXXXXXXXXXIXXXXXXXXXXXIJJJIXXXXXXXXXXHXXXXXXXXXXXB
BXXXXXXXXXXXXXXXXXXIJJJJJJJJJIXXXXXXXXXXXXXXXXXXXXXXJJJJFXXXXXXXXKKKXXXXXXXXXXXXXXXIIIXXXXXXXXXXXXXXXXXXXXXXXXXIXXXIXXXIXXXJJJJJFXXXXXXXXXHXXXXXXXXXXEB
BSSIIIIIIIIXXXIIIIIJJJJJJJJJJJJIXXXIIXXXIIXXXIIXXXIIJJJJIXXXIIIIIIIIIIIIIXXXXXXXXXXXXXXXXXXXXXXXXIIIIIIIIIIIIIIIIIIIIIIIIIIJJJJJIXXXIIIIIIIIIIIXXXXXXXB
BSSSSJJJJJJWWWJJJJJJJJJJJJJJJJJJWWWJJWWWJJWWWJJWWWIJJJJJJWWWJJJJJJJJJJJJJWWWWWWWWWWWWWWWWWWWWWWWWJJJJJJJJJJJJJJJJJJJJJJJJJJJJJJJJWWWJJJJJJJJJJJIIIIIIIB