BGGGGGGGGGGGGGGGGGGGGGGGCGGGGGGGGGGGGCGGGGGGGGGGCGGGGGGGGGGGGGGGGGGGGGGGGGCGGGGGGGXXXXDDVCGGGGGGGGCGGGGGGGCGGGGGGGGB
BGXXXXXXXXXXXXXGGGGGGGGXXXXXXXXXXXXXXXXXXXXXXXXXXXXXXXXXXXGGXXXXXXXXXXXXXXXXXXXXXXXXXXXXXGXXXXXXXXXXXXXXXXXXXGGGGGGB
BXXXXXXXXXXXXXXXGGGGGXXXXXXXXXXXXXXXXXXXXXXXXXXXXXXXXXXXXXXXXXXXXXXXXXXXXXXXXXXXXXXXXXXXXXXXXXXXXXXXXXXXXXXXXXXXXGGB
BXXXXXXXXXXXXXXXXXXXXXXXXXXXXXXXXXXXXXXXXXXXXXXXXXXXXXXXXXXXXXXXXXXXXXXXXXXXXXXXXGXXGGXXXXXXXXXXGGXXXXXXXXXXXXXXXXXB
BXXXXXXXXXXXXXXXXXXXXXXXXXXXXXXXXXXXXGXXXXXXXXXXXXXXXXXXXXXXXXXXXXXXXXXXXXXXXXXXXXXXXXXXXXXXXXXXXXXXXXXXXXXXXXXXXXXB
BXXXXXXXXXXXXXXXXXXXXXXXXXXXXXXXXXXGXXXXXXXXXXXXXXXKXXXXXXXXXXXXXGGPPXXXGGXXXXXGXXXXXGGGXXXGGGXXXXXXXXXXXXXXXXXXXXXB
BXXXXXXXKXXXXXXXXXXXXXXXXXXXXXXXXGXXXXXXXXXXXGGXXXGGXXXXXXXXXXFXXXXXXXXXXXXXXXXXXXXXXXXXXXXXXXXXXXVDXMXVDDXXXXXXXXXB
BXXXXXXXKXXXXXXXXXXXXXXXXXXXXXXGXXXXXGXXMXXGXXXXXXXXXXXXXXXXXGGGXXXXXXXXXXXXXXXXXXXXXXXXXXXXXXXXXXGGGGGGXXXXXXXXXXXB
BXXXXXXXKXXXXXXXXXXXXXXXXXXXXXXXXXXXXGGGGGGGXXXXXXXXGGGPPXXXXGGGXXXXXXXXXXXXGGGXXXXXXXXXXXXXXXXXXXXXXXXXXXXXXXXFXXXB
BXXXXXXGGGXXXXXXXXXXXXDDVDDFGGXXXXXXXXXXXXXXXXXXXXXXGGGXXXXXXGGGXXXXXXXXXXXXXXXXXXXXXXXXXXXXXXXXXXXXXXXXXXXXXXXKXXEB
BGXXXXGGGGXXGGGXXXXXMGGGGGGGGGXXXXXXXXXXXXXXXXXXXXXXGGGXXXXXXGGGXXXXXXXXXXGXXXXXXXXXXXXXXXXXXXXXXXXXXXXXXXXGGGGGGGGB
BGGGGGGGGGWWGGGGGGGGGGGGGGGGGGWWWWWWWWWWWWWWWWWWWWWWGGGGGGGGGGGGWWWWWWWWWWGWWWWWWWWWWWWWWWWWWWWWWWWWWWWWWWWGGGGGGGGB