BGGGGGGGGGGGGGGGGGGGGGGGGGGCGGGGGGGGGGGGCGGGGGGGGGGCGGGGGGGGGGGGGGGGGGGGGGGGGCGGGGGXXXXXXXDDVCGGGGGGGGCGGGGGGGCGGCGCGGGGGGGGGGGB
BGXXXXXXXXXXXXXXGGGGGGGGXXXXXXXXXXXXXXXXXXXXXXXXXXXXXXXXXXXXXGGXXXXXXXXXXXXXXXXXXXXXXXXXXXXXXXXXXXXXXXXXXXXXXXXXXXXXXXXXXGGGGGGB
BXXXXXXXXXXXXXXXXGGGGGXXXXXXXXXXXXXXXXXXXXXXXXXXXXXXXXXXXXXXXXXXXXXXXXXXXXXXXXXXXXXXXXXXXXXXXXXXXXXXXXXXXXXXXXXXXXXXXXXXXXXXXGGB
BXXXXXXXXXXXXXXXXXXXXXXXXXXXXXXXXXXXXXXXXXXXXXXXXXXXXXXXXXXXXXXXXXXXXXXXXXXXXXXXXXXXXGXXGGXXXXXXXXXXGGXXXXXXXXXXXXXXXXXXXXXXXXGB
BXXXXXXXXXXXXXXXXXXXXXXXXXXXXXXXXXXXXXXXGXXXXXXXXXXXXXXXXXXXXXXXXXXXXXXXXXXXXXXXXXXXXXXXXXXXXXXXXXXXXXXXXXXXXXXXXXXXXXXXXXXXXXXB
BXXXXXXXXXXXXXXXXXXXXXXXXXXXXXXXXXXXXXGXXXXXXXXXXXXXXXKXXXXXXXXXXXXXGGPPXXXGGXXXXXXGXXXXXGGGXXXGGGXXXXXXXXXXXXGGKKKKKGGXXXXXXXXB
BXXXXXXXXKXXXXXXXXXXXXXXXXXXXXXXXXXXGXXXXXXXXXXXGGXXXGGXXXXXXXXXXFXXXXXXXXXXXXXXXXXXXXXXXXXXXXXXXXXXXXVDXMXVDDXXXXXXXXXXXXXXXXXB
BXXXXXXXXKXXXXXXXXXXXXXXXXXXXXXXXXGXXXXXGXXMXXGXXXXXXXXXXXXXXXXXGGGXXXXXXXXXXXXXXXXXXXXXXXXXXXXXXXXXXXGGGGGGXXXXXXXXXXXXXXXXXXXB
BXXXXXXXXKXXXXXXXXXXXXXXXXXXXXXXXXXXXXXXGGGGGGGXXXXXXXXGGGPPXXXXGGGXXXXXXXXXXXXXGGGXXXXXXXXXXXXXXXXXXXXXXXXXXXXXXXXXXXXXXXXFXXEB
BXXXXXXXGGGXXGGXXXXXXXXXXDDVDDFGGXXXXXXXXXXXXXXXXXXXXXXGGGXXXXXXGGGXXXXXXXXXXXXXXXXXXXXXXXXXXXXXXXXXXXXXXXXXXXXXXXXXXXXXXXXKXXXB
BGXXXXGGGGGWWGGGXXXXXXXMGGGGGGGGGXXXXXXXXXXXXXXXXXXXXXXGGGXXXXXXGGGXXXXXXXXXXGGXXXXXXXXXXXXXXXXXXXXXXXXXXXXXXXXXXXXXXXXGGGGGGGGB
BGGGGGGGGGGUUGGGGGGGGGGGGGGGGGGGGWWWWWWWWWWWWWWWWWWWWWWGGGGGGGGGGGGWWWWWWWWWWGGWWWWWWWWWWWWWWWWWWWWWWWWWWWWWWWWWWWWWWWWGGGGGGGGB