BXXXXXXXXXXXXXXXXXXXXXXXXXXXXXXXXXXXXXXXXXXXXXXXXXXXXXXXXXXXXXXXXXXXXXXXXXXXXXXXXXXXXXXXXXXXXXXXXXXXQQQQQXXXXXXXXXXXXXXXXXXXXXXB
BXXXXXXXXXXXXXXXXXXXXXXXXXXXXXXXXXXXXXXXXXXXXXXXXXXXXXXXXXXXXXXXXXXXXXXXXXXXXXXXXXXXXXXXXXXXXXXXXXXXXXXXXXXXXXXXXXXXXXXXXXXXXXXB
BXXXXXXXXXXXXXXXXXXXXXXXXXXXXXXXXXXXXXXXXXXXXXXXXXXXXXXXXXXXXXXXXXXXXXXXXXXXXXXXXXXXXXXXXXXXXXXXXXXXXXXXXXXXXXXXXXXXXXXXXXXXXXXB
BXXXXXXXXXXXXXXXXXXXXXXXXXXXXXXXXXXXXXXXXXXXXXXXXXXXXXXXXXXXXXXXXXXXXXXXXXXXXXXXXXXXXXXXXXXXXXXXXXXXXXXXXXXXXXXXXXXXXXXXXXXXXXXB
BXXXXXXXXXXXXXXXXXXXXXXXXXXXXXXXXXXXXXXXXXXXXXXXXXXXXXXXXXXXXXXXXXXXXXXXXXXXXXXXXXXXXXXXXXXXXXXXXXXXXXXXXXXXXXXXXXXXXXXXXXXXXXXB
BXXXXXXXXXXXXXXXXXXXXXXXXXXXXXXXXXXXXXXXXXXXXXXXXXXXXXXXXXXXXXXXXXXXXXXXXXXXXXXXXXXXXXXXXXXXXXXXXXXXXXXXXXXXXXXXXXXXXXXXXXXXXXXB
BXXXXXXXXXXXXXXXXXXXXXXXXXXXXXXXXXXXXXXXXXXXXXXXXXXXXXXXXXXXXXXXXXXXXXXXXXXXXXXXXXXXXXXXXXXXXXXXXXXXXXXXXXXXXXXXXXXXXXXXXXXXXXXB
BXXXXXXXXXXXXXXXXXXXXXXXXXXXXXXXXXXXXXXSSXXXSSSXXXXXXXXXXXXXXXXXXXXXXXXXXXXXXXXXXXXXXXXSXXXSXXXXXXXSSSSSSSXXXXXXXXXXXXXXXXXXXXXB
BXXXXXXXXXXXXXXXXXXXSSSXXXXXXXXXXXXXXSSSSXXXSSSXXXXXXXXXXXXXXXXXXXXXXXXXXXXXXXXXKXXXXXSSWWWSSXXXXXXXKXXXXXXXXXXXXXXXXXSSSXXFXXXB
BXXXXXXXXXXSSSXXXXXXSSSXXXXXXXXXXXXSSSSSSXXXSSSXXXXXXXXXXXXXXXXXXXXXXXSSSSXXXXXXKXXXXSSSSSSSSSXXFXXXKXXXXXXXXXXXXXXXSSSSSSSSXXEB
BXXSSSXXXXXSSSXXXXXXSSSXXXXSSSXXXSSSSSSSSWWWSSSXXXXXSSSXXSSSXXSSSXXSSSSSSSSXXXXXKXXFSSSSSSSSSSSSSSSSSSSSSSSSSXXXSSSSSSSSSSSSSSSB
BWWSSSSSSSSSSSSSSSSSSSSSSSSSSSSSSSSSSSSSSWWWSSSSSSSSSSSWWSSSWWSSSWWSSSSSSSSSSSSSSSSSSSSSSSSSSSSSSSSSSSSSSSSSSWWWSSSSSSSSSSSSSSSB
