BXXXXXXXXXXXXXXXXXXXXXXLLLXXXXXXXXXXXXXXXXXXXXXXXXXXXXXXXXXXXXXXXXXXXXXXXXXXXXXXXXXXXXXXXXXXXXXXXXXXXXXCXXXCXXXCXXXCXXXCXXXCXXXCXXXXXXXXXXXXXXXXXXXXXXB
BXXXXXXXXXXXXXXXXXXXXXXLLLXXXXXXXXXXXXXXXXXXXXXXXXXXXXXXXXXXXXXXXXXXXXXXXXXXXXXXXXXXXXXXXXXXXXXXXXXXXXXXXXXXXXXXXXXXXXXXXXXXXXXXXXXXXXXXXXXXXXXXXXXXXXB
BXXXXXXXXXXXXXXXXXXXXXXLLLXXXXXXXXXXXXXXXXXXXXXXXXXXXXXXXXXXXXXXXXXXXXXXXXXXXXXXXXXXXXXXXXXXXXXXXXXXXXXXXXXXXXXXXXXXXXXXXXXXXXXXXXXXXXXXXXXXXXXXXXXXXXB
BXXXXXXXXXXXXXXXXXXXXXXXHXXXXXXXXXXXXXXXXXXXXXXXXXXXXXXXXXXXXXXXXXXXXXXXXXXXXXXXXXXXXXXXXXXXXXXIIIXXXXXXXXXXXXXXXXXXXXXXXXXXXXXXXXXXXXXXXXXXXXXXXXXXXXB
BXXXXXXXXXXXXXXXXXXXXXXXHXXXXXXXXXXXXXXXXXXXXXXXXXXXXIIIIXXXXXXXXXXXXXXXXXXXXXXXXIIKKKIIXXXIIXXXXXXXXXXXXXXXXXXXXXXXXXXXXXXXXXXXXXXXXXXXXLLLXXXXXXXXXXB
BXXXXXXXXXXXXXXXXXXXXXXXHXXXXXXXXXXXXXXXXXXXXXXXXXXXXIIIIXXXXXXXXXXXXXXXXXXXXXXXXXXXXXXXXXXXXXXXXXXXXXXXXXXXXXXXXXXXXXXXXXXXXXXXXXXXXXXXXLLLXXXXXXXXXXB
BXXXXXXXXXXXXXXXXXXXXXIIIIIXXXXXXXXXXXFXXXXXXXXXXXXXXIIIIXXXXXXXXXXXXXXXXXXXXXIIXXXXXXXXXXXXXXXXXXXXXXXXXXXXXXXXXXXXXXXXXXXXIIIXXXXXXXXXXLLLXXXXXXXXXXB
BXXXXXXXXXXXXXXXXXXXXIIIIIIIXXXXXXXXXXIXXXXXXXXXXXXXIIIIXXXXXXXXXXKXXXXXXXXXXXXXXXXXXXXXXXXXXXXXXXXXXXXXXXXXFXXXXXXXXXXXXXXXIIIXXXXXXXXXXXHXXXXXXXXXXXB
BXXXXXXXXXXXXXXXXXXXIIIIIIIIIXXXXXXXXXXXXXXXXXXXXXXXIIIIXXXXXXXXXKKKXXXXXXIIIXXXXXXXFXXXXXXXXXXXXXXXXXXXXXXXXXXIXXXXXXXXXXXIIIIIXXXXXXXXXXHXXXXXXXXXXXB
BXXXXXXXXXXXXXXXXXXIIIIIIIIIIIXXXXXXXXXXXXXXXXXXXXXXIIIIFXXXXXXXXKKKXXXXXXXXXXXXXXXIIIXXXXXXXXXXXXXXXXXXXXXXXXXIXXXIXXXIXXXIIIIIFXXXXXXXXXHXXXXXXXXXXEB
BSSIIIIIIIIXXXIIIIIIIIIIIIIIIIIIXXXIIXXXIIXXXIIXXXIIIIIIIXXXIIIIIIIIIIIIIXXXXXXXXXXXXXXXXXXXXXXXXIIIIIIIIIIIIIIIIIIIIIIIIIIIIIIIIXXXIIIIIIIIIIIXXXXXXXB
BSSSSIIIIIIWWWIIIIIIIIIIIIIIIIIIWWWIIWWWIIWWWIIWWWIIIIIIIWWWIIIIIIIIIIIIIWWWWWWWWWWWWWWWWWWWWWWWWIIIIIIIIIIIIIIIIIIIIIIIIIIIIIIIIWWWIIIIIIIIIIIIIIIIIIB