BXXXXXXXXXXXXXXXXXXXXXXXXCXXXXXXXXXXXXXXXXXXXXXXXXXXXCXXXXXXXCXXXXXXXXXXXXXXXXXXQQQQQXXXXXCXXXXXXXXXXXXXXXCXXXXXXXXXXXB
BXXXXXXXXXXXXXXXXXXXXXXXXXXXXXXXXXXXXXXXXXXXXXXXXXXXXXXXXXXXXXXXXXXXXXXXXXXXXXXXXXXXXXXXXXXXXXXXXXXXXXXXXXXXXXXXXXXXXXB
BXXXXXXXXXXXXXXXXXXXXXXXXXXXXXXXXXXXXXXXXXXXXXXXXXLLLXXXXXXXXXXXXXXXXXXXXXXXXXXXXXXXXXXXXXXXXXXXXXXXXXXXXXXXXXXXXXXXXXB
BXXXLLLXXXXXXXXXFXXXXXXXXXXXXXXXXXOOXXKXXOOXXXXXXXLLLXXXXXXXXXXXXXXXXXXXXXXXXXXXXXXXXXXXXXXXXXXXXXXXXXXXXXXXXXXXXXXXXXB
BXXXLLLXXXXXXXXOOOOXXXXXXXXXXXXXOXXXXXXXXXXKXXXXXXLLLXXXXXXXXXXXXLLLXXXXXXXXXFXXXXXXXXXXXXXXXXXXXXXXXXXXOXXXXXXXXXXXXXB
BXXXLLLXXXXXXXXXXXXXXXXXXXXXXXOXXXXXXXXXXXXXKXXXXXXHXXXXXXXXXXXXXLLLXXXXXXXXXKXXXXXXXXXXXXXXXXXXXXXXXXOXXXXXXXXXXXXXXXB
BXXXXHXXXXXXXXXXXXXXXXOOXXXOOXXXXXXXXXXXXXXXXKXXXXXHXXXXXXXXXXFXXLLLXXXXXXXKXXXXKKKKKXXXXXXXDDVXXXXXXXXXXXXXXXXXXXXXXXB
BXXXXHXXXXXXXXXXXXXXXXXXXXXXXXXXXXXXXXXXXXXXXXXXXXXHXXXXXXXXXXOXXXHXXXXXXKXXXXXXXXXXXXXXXXXOOOOXKXOMOXXXXXXXXXXXXXXXXXB
BXXXXHXXXXXXXXXXXXXDVDXXXXXXXXXXXXXXXXXXXXXXXXXXXFXHXXXOOOOOXXOXXXHXXXXXXXXXXXXXXXXXXXXXXXXXXXXXXXXOXXXXXXXXXXXXXXXXXEB
BOXXXHXXXXXXXXXXOOXOOXXXXXXXXXXXXXXXXXXXXXXXXXXXOOOOOOOOOOOOXXOXXXHXXXXKXXXXXXXXXXXXXXXXOOXXXXXXXXXXXXXXXXXXXXXXXXXXOOB
BOOXXHXXOXXOXMXOOOWOOOXXXXXXXXXXXXXXXXXXXXXXXXOOOOOOOOOOOOOOXXXMXXHXXXXXXXDVDXOOOOOOOOOXXXXXXXXXXXXXXXXXXXOXXMXXMXXOOOB
BOOOOOOOOWWOOOOOOOUOOOOWWWWWWWWWWWWWWWWWWWWWWOOOOOOOOOOOOOOOOOOOOOOOOOOOOOOOOOOOOOOOOOOWWWWWWWWWWWWWWWWWWWOOOOOOOOOOOOB