BXXXXXXXXXXXXXXXXXXXXXXXFXXXXXXXXXXXXXXXXXXXXXXXXXXXXXXXXXXXXXXXXXXXXXXXXXXXXXXXIXXXXCXXXXCXXXXXCXXXCXXXXXXXXXXB
BXXXXXXXXXXXXXXXXXXXXXXXXXXXXXXXXXXXXXXXXXXXXXXXXXXXXXXXXXXXXXXXXXXXXXXXXXXXXXXFIXXXXXXXXXXXXXXXXXXXXXXXXXXXXXXB
BXXXXXXXXXXXXXXXXXXXXXXXXXXXXXXXXXDDVXXXXXXXXIIIIXXXXXXXXXXXXXXXXXXXXXIIIIIIIIIIIXXXXXXXXXXXXXXXXXXXXXXXXXXXXXXB
BXXXXXXXXXXXXXXXXXXXXXXXXXXXXXXXIIIIIXXXIIIXXIIIIXXXXXXXXXXXXXXXXXXXXXXXXXXXXXDDVXXXXXXXXXXXXXXXXXXXXXXXXXXXXXXB
BXXXXXXXXXXXXXXXXXXXXXXXXXXXXIXXXXXXXXXXXXXXXIIIIXXXXXXXXXXXXXXXXXXXXXXXXXXXXXDDVXXXXXXXXXXXXXXXXXXXXXXXXXLLLXXB
BXXXXXXXXXXXXXXXXXXXXXXXXXXXXXXXXXXXXXXXXXXXXIIIIXXXXXXXXXXXXXXXXXXXXIIIIIIIIIIIIXXXXXXXXXXXXXXXXDVDXXXXXXLLLXXB
BXXXXXXXXXXXXXXXXXXXIIIXXXIXXXXXXXXXXXTXXXXXXIIIIXXXXXXXXXXXXXXXXXXXXXXXXXXXXXXXKXXXXXXXXXXXXXXXXXXXXXXXXXLLLXXB
BXXXXXXXXXXXXXXXXXXXXXXXXXXXXXXXXXXXXXXXXXXXXIIIIXXXXXXXXXXXXXXXXXXXXXXXXXXXXXXXKXXXXXXXXXXXXXXXXXXXXXXXXXXHXXXB
BXXXXXXXXXXXXXXXXIIXXXXXXXXXXXXXXXXXXXXXXXXXXIIIIXXXXXXXXXXXXXXXXXXXIIIIIIIIIIIIIXXXXXXXVDDXXXXXXIIIXXXXXXXHXXXB
IBXXXXXDDVXFXXXXXXXXXXXXXXXXXXXXXXXXXXXXXXXXXXXXIXXXXXXXXXXXXXXXVDDXXXXXXXXXXXXXXXXXXXXXIXXDVDXXXIIIFXXXXXXHXXXB
BXXXIIIIIIIXXXIIIIIIIXXXXXXXXXXXXXXXXXXXXXXXXXXFIXXXIIXXXXXIXXIIIIIIXXXXXXXXXXXXXXIIIIIIIIIIIIIIIIIIIXXXIIIIIIIB
BIIIIIIIIIIWWWIIIIIIIIIIIIIIIIIIIIIIIIIIIIIIIIIIIWWWIIIIIIIIWWIIIIIIWWWWWWWWWWWWWWIIIIIIIIIIIIIIIIIIIWWWIIIIIIIB
