BXXXXXXXXXXXXXXXXXXXXXXXXCXXXXXXXXXXXXXXXXXXXXXXXXXXXCXXXXXXXCXXXXXXXXXXXXXXXQQQQQXXXXXCXXXXXXXXXXXXXXXCXXXXXXXXXXXB
BXXXXXXXXXXXXXXXXXXXXXXXXXXXXXXXXXXXXXXXXXXXXXXXXXXXXXXXXXXXXXXXXXXXXXXXXXXXXXXXXXXXXXXXXXXXXXXXXXXXXXXXXXXXXXXXXXXB
BXXXXXXXXXXXXXXXXXXXXXXXXXXXXXXXXXXXXXXXXXXXXXXXXXLLLXXXXXXXXXXXXXXXXXXXXXXXXXXXXXXXXXXXXXXXXXXXXXXXXXXXXXXXXXXXXXXB
BXXXLLLXXXXXXXXXFXXXXXXXXXXXXXXXXXOOXXKXXOOXXXXXXXLLLXXXXXXXXXXXXXXXXXXXXXXXXXXXXXXXXXXXXXXXXXXXXXXXXXXXXXXXXXXXXXXB
BXXXLLLXXXXXXXXOOOOXXXXXXXXXXXXXOXXXXXXXXXXKXXXXXXLLLXXXXXXXXXXXLLLXXXXXXXFXXXXXXXXXXXXXXXXXXXXXXXXXXOXXXXXXXXXXXXXB
BXXXLLLXXXXXXXXXXXXXXXXXXXXXXXOXXXXXXXXXXXXXKXXXXXXHXXXXXXXXXXXXLLLXXXXXXXKXXXXXXXXXXXXXXXXXXXXXXXXOXXXXXXXXXXXXXXXB
BXXXXHXXXXXXXXXXXXXXXXOOXXXOOXXXXXXXXXXXXXXXXKXXXXXHXXXXXXXXXXFXLLLXXXXXKXXXXKKKKKXXXXXXXDDVXXXXXXXXXXXXXXXXXXXXXXXB
BXXXXHXXXXXXXXXXXXXXXXXXXXXXXXXXXXXXXXXXXXXXXXXXXXXHXXXXXXXXXXOXXHXXXXKXXXXXXXXXXXXXXXXXOOOOXKXOMOXXXXXXXXXXXXXXXXXB
BXXXXHXXXXXXXXXXXXXDVDXXXXXXXXXXXXXXXXXXXXXXXXXXXFXHXXXOOOOOXXOXXHXXXXXXXXXXXXXXXXXXXXXXXXXXXXXXOXXXXXXXXXXXXXXXXXEB
BOXXXHXXXXXXXXXXOOXOOXXXXXXXXXXXXXXXXXXXXXXXXXXXOOOOOOOOOOOOXXOXXHXXKXXXXXXXXXXXXXXXXOOXXXXXXXXXXXXXXXXXXXXXXXXXXOOB
BOOXXHXXOXXOXMXOOOWOOOXXXXXXXXXXXXXXXXXXXXXXXXOOOOOOOOOOOOOOXXXMXHXXXXXDVDXOOOOOOOOOXXXXXXXXXXXXXXXXXXXOXXMXXMXXOOOB
BOOOOOOOOWWOOOOOOOWOOOOWWWWWWWWWWWWWWWWWWWWWWOOOOOOOOOOOOOOOOOOOOOOOOOOOOOOOOOOOOOOOWWWWWWWWWWWWWWWWWWWOOOOOOOOOOOOB