BXXXXXXXXXXXXXXXXXXXXXXXXXXXXFXXXXXXXXXXXXXXXXXXXXXXXXXXXXXXXXXXXXXXXXXXXXXXXXXXXXXXXXXXXXXXZXXXXCXXXXCXXXXXCXXXCXXXXXXXXXXXXXXXXXXXXXRQQQQQQQQQQRXXXXXXXB
BXXXXXXXXXXXXXXXXXXXXXXXXXXXXXXXXXXXXXXXXXXXXXXXXXXXXXXXXXXXXXXXXXXXXXXXXXXXXXXXXXXXXXXXXXXFZXXXXXXXXXXXXXXXXXXXXXXXXXXXXXXXXXXXXXXXXXXXXXXXXXXXXXXXXXXXXB
BXXXXXXXXXXXXXXXXXXXXXXXXXXXXXXXXXXXXXX##VXXXXXXXXZZZZZXXXXXXXXXXXXXXXXXXXXXXZZZZZZZZZZZZZKKZXXXXXXXXXXXXXXXXXXXXXXXXXXXXXXXXXXXXXXXXXXXXXXXXXXXXXXXXXXXXB
BXXXXXXXXXXXXXXXXXXXXXXXXXXXXXXXXXXXXZZZZZXXXZZZXXZZZZZXXXXXXXXXXXXXXXXXXXXXXXXXXXXXXXXXXX##VXXXXXXXXXXXXXXXXXXXXXXXXXXXXXXXXXXXXXXXXKKKKKKKKKKKKKXXXXXXXB
BXXXXXXXXXXXXXXXXXXXXXXXXXXXXXXXXXZXXXXXXXXXXXXXXXZZZZZXXXXXXXXXXXXXXXXXXXXXXXXXXXXXXXXXXX##VXXXXXXXXXXXXXXXX#VDXXXXXXLLLXXXXXXXXXXXXXXXXXXXXXXXXXXXXXXXEB
BXXXXXXXXXXXXXXXXXXXXXXXXXXXXXXXXXXXXXXXXXXXXXXXXXZZZZZXXXXXXXXXXXXXXXXXXXXXZZZZZZZZZZZZZZZZZXXXXXXXXXXXXXXXXXXXXXXXXXLLLXXXXXXXXXXXXXXXXXXXXXXXXXXXXXXZXB
BXXXXXXXXXXXXXXXXXXXXXXXXZZZXXXZXXXLLLXXXXXXXXXXXXZZZZZXXXXXXXXXXXXXXXXXXXXXXXXXXXXXXXXXXXXXKXXXXXXXXXXXXXXXXXXXXXXXXXLLLXXXXXXXXXXXXXXXXXXXXXXXXXXXZXXXXB
BXXXXXXXXXXXXXXXXXXXXXXXXXXXXXXXXXXLLLXXXXXXXXXXXXZZZZZXXXXXXXXXXXXXXXXXXXXXXXXXXXXXXXXXXXXXKXXXXXXXXXXXXXXXXXXXXXXXXXXHXXXXXXXXXXXXXKKKKKKKKKKKKZXXXXXXXB
BXXXXXXXXXXXXXXXXXXXXXZZXXXXXXXXXXXLLLXXXXXXXXXXXXZZZZZXXXXXXXXXXXXXXXXXXXXZZZZZZZZZZZZZZZZZZXXXXXXXVDDXXXXXXZZZXXXXXXXHXXXXXXXXZZXXXQQQQQQQQQQQQQXXXXXXXB
BXXXXXXXXXXX#VXFXXXXXXXXXXXXXXXXXXXXHXXXXXXXXXXXXXXXXXKXXXXXXXXXXXXXXXVDDXXXXXXXXXXXXXXXXXXXXXXXXXX#VDD#VDXXXZZZFXXXXXXHXXXXXXXZZZXXXXXXXXXXXXXXXXXXXXXXXB
BXXXXXXXZZZZZZZZXXXZZZZZZZXXXXXXXXXXHXXXXXXXXXXXXXXXXFKXXXZZXXXXXZXXZZZZZZXXXXXXXXXXXXXXXXXXXXZZZZZZZZZZZZZZZZZZZXXXZZZZZZZZZZZZZZXXXXXXXXXXXXXXXXXXXXXXXB
BZZZZZZZZZZZZZZZWWWZZZZZZZZZZZZZZZZZZZZZZZZZZZZZZZZZZZZWWWZZZZZZZZWWZZZZZZWWWWWWWWWWWWWWWWWWWWZZZZZZZZZZZZZZZZZZZWWWZZZZZZZZZZZZZZZZZZZZZZZZZZZZZZZZZZZZZB
