BXXXXXXXXXXXXXXXXXXXXXXXXXXXXXXXXXXXXXXXXXXXXXXXXXXXXXXXXXXXXXXXXXXXXXXXXXXXXXXXXXXXXXXXXXXXXXXXCCCCCXXXXXXXXXXXXXXXXXXXXXXB
BXXXXXXXXXXXXXXXXXXXXXXXXXXXXXXXXXXXXXXXXXXXXXXXXXXXXXXXXXXXXXXXXXXXXXXXXXXXXXXXXXXXXXXXXXXXXXXXXXXXXXXXXXXXXXXXXXXXXXXXXXXB
BXXXXXXXXXXXXXXXXXXXXXXXXXXXXXXXXXXXXXXXXXXXXXXXXXXXXXXXXXXXXXXXXXXXXXXXXXXXXXXXXXXXXXXXXXXXXXXXXXXXXXXXXXXXXXXXXXXXXXXXXXXB
BXXXXXXXXXXXXXXXXXXXXXXXXXXXXXXXXXXXXXXXXXXXXXXXXXXXXXXXXXXXXXXXXXXXXXXXXXXXXXXXXXXXXXXXXXXXXXXXXXXXXXXXXXXXXXXXXXXXXXXXXXXB
BXXXXXXXXXXXXXXXXXXXXXXXXXXXXXXXXXXXXXXXXXXXXXXXXXXXXXXXXXXXXXXXXXXXXXXXXXXXXXXXXXXXXXXXXXXXXXXXXXXXXXXXXXXXXXXXXXXXXXXXXXXB
BXXXXXXXXXXXXXXXXXXXXXXXXXXXXXXXXXXXXXXXXXXXXXXXXXXXXXXXXXXXXXXXXXXXXXXXXXXXXXXXXXXXXXXXXXXXXXXXXXXXXXXXXXXXXXXXXXXXXXXXXXXB
BXXXXXXXXXXXXXXXXXXXXXXXXXXXXXXXXXXXXXXXXXXXXXXXXXXXXXXXXXXXXXXXXXXXXXXXXXXXXXXXXXXXXXXXXXXXXXXXXXXXXXXXXXXXXXXXXXXXXXXXXXXB
BXXXXXXXXXXXXXXXXXXXXXXXXXXXXXXXXXXSSXXXSSSXXXXXXXXXXXXXXXXXXXXXXXXXXXXXXXXXXXXXXXXSXXXSXXXXXXXSSSSSSSXXXXXXXXXXXXXXXXXXXXXB
BXXXXXXXXXXXXXXXSSSXXXXXXXXXXXXXXSSSSXXXSSSXXXXXXXXXXXXXXXXXXXXXXXXXXXXXXXXXKXXXXXSSWWWSSXXXXXXXKXXXXXXXXXXXXXXXXXSSSXXFXXXB
BXXXXXXXXXXXXXXXSSSXXXXXXXXXXXXSSSSSSXXXSSSXXXXXXXXXXXXXXXXXXXXXXXSSSSXXXXXXKXXXXSSSSSSSSSXXFXXXKXXXXXXXXXXXXXXXSSSSSSSSXXEB
BXXSSSXXXXXMXXXXSSSXXXXSSSXXXSSSSSSSSWWWSSSXXXXXSSSXXSSSXXSSSXXSSSSSSSSXXXXXKXXFSSSSSSSSSSSSSSSSSSSSSSSSSXXXSSSSSSSSSSSSSSSB
BWWSSSSSSSSSSSSSSSSSSSSSSSSSSSSSSSSSSWWWSSSSSSSSSSSWWSSSWWSSSWWSSSSSSSSSSSSSSSSSSSSSSSSSSSSSSSSSSSSSSSSSSWWWSSSSSSSSSSSSSSSB
