BXXXXXXXXXXXXXXXXXXXXXXLLLXXXXXXXXXXXXXXXXXXXXXXXXXXXXXXXXXXXXXXXXXXXXXXXXXXXXXXXXXXXXXXXXXXXXXXXCXXXCXXXCXXXCXXXCXXXCXXXCXXXXXXXXXXXXXXXXXXXXB
BXXXXXXXXXXXXXXXXXXXXXXLLLXXXXXXXXXXXXXXXXXXXXXXXXXXXXXXXXXXXXXXXXXXXXXXXXXXXXXXXXXXXXXXXXXXXXXXXXXXXXXXXXXXXXXXXXXXXXXXXXXXXXXXXXXXXXXXXXXXXXB
BXXXXXXXXXXXXXXXXXXXXXXLLLXXXXXXXXXXXXXXXXXXXXXXXXXXXXXXXXXXXXXXXXXXXXXXXXXXXXXXXXXXXXXXXXXXXXXXXXXXXXXXXXXXXXXXXXXXXXXXXXXXXXXXXXXXXXXXXXXXXXB
BXXXXXXXXXXXXXXXXXXXXXXXHXXXXXXXXXXXXXXXXXXXXXXXXXXXXXXXXXXXXXXXXXXXXXXXXXXXXXXXXXXXXXXXXXIIIXXXXXXXXXXXXXXXXXXXXXXXXXXXXXXXXXXXXXXXXXXXXXXXXXB
BXXXXXXXXXXXXXXXXXXXXXXXHXXXXXXXXXXXXXXXXXXXXXXXXXXXXIIIIXXXXXXXXXXXXXXXXXXXIIKKKIIXXXIIXXXXXXXXXXXXXXXXXXXXXXXXXXXXXXXXXXXXXXXXXXLLLXXXXXXXXXB
BXXXXXXXXXXXXXXXXXXXXXXXHXXXXXXXXXXXXXXXXXXXXXXXXXXXXIIIIXXXXXXXXXXXXXXXXXXXXXXXXXXXXXXXXXXXXXXXXXXXXXXXXXXXXXXXXXXXXXXXXXXXXXXXXXLLLXXXXXXXXXB
BXXXXXXXXXXXXXXXXXXXXXIIIIIXXXXXXXXXXXFXXXXXXXXXXXXXXIIIIXXXXXXXXXXXXXXXXIIXXXXXXXXXXXXXXXXXXXXXXXXXXXXXXXXXXXXXXXXXXXIIIXXXXXXXXXLLLXXXXXXXXXB
BXXXXXXXXXXXXXXXXXXXXIIIIIIIXXXXXXXXXXIXXXXXXXXXXXXXIIIIXXXXXXXXXXXXXXXXXXXXXXXXXXXXXXXXXXXXXXXXXXXXXXFXXXXXXXXXXXXXXXIIIXXXXXXXXXXHXXXXXXXXXXB
BXXXXXXXXXXXXXXXXXXXIIIIIIIIIXXXXXXXXXXXXXXXXXXXXXXXIIIIXXXXXXXXXXXXXIIIXXXXXXXFXXXXXXXXXXXXXXXXXXXXXXXXXIXXXXXXXXXXXIIIIIXXXXXXXXXHXXXXXXXXXXB
BXXXXXXXXXXXXXXXXXXIIIIIIIIIIIXXXXXXXXXXXXXXXXXXXXXXIIIIFXXXXXXXXXXXXXXXXXXXXXIIIXXXXXXXXXXXXXXXXXXXXXXXXIXXXIXXXIXXXIIIIIXXXXXXXXXHXXXXXXXXXXB
BSSXXXXXXXXXXXXXXXIIIIIIIIIIIIIIWWWIIWWWIIWWWIIWWWIIIIIIIXXXXIIIIIIIXXXXXXXXXXXXXXXXXXXXXXXXIIIIIIIIIIIIIIIIIIIIIIIIIIIIIIFXXXXXIIIIIIIIXXXXXEB
BSSSSIIIIIIWWWIIIIIIIIIIIIIIIIIIIIIIIIIIIIIIIIIIIIIIIIIIIWWWWIIIIIIIWWWWWWWWWWWWWWWWWWWWWWWWIIIIIIIIIIIIIIIIIIIIIIIIIIIIIIIXXXIIIIIIIIIIIGGGGGB