BXXXXXXXXXXXXXXXXXXXXXXXXXXXXFXXXXXXXXXXXXXXXXXXXXXXXXXXXXXXXXXXXXXXXXXXXXXXXXXXXXXXXXXXXXXXXZXXXXCXXXXCXXXXXCXXXCXXXXXXXXXXXXXXXXXXXXXRQQQQQQQQQQRXXXXXXXB
BXXXXXXXXXXXXXXXXXXXXXXXXXXXXXXXXXXXXXXXXXXXXXXXXXXXXXXXXXXXXXXXXXXXXXXXXXXXXXXXXXXXXXXXXXXXFZXXXXXXXXXXXXXXXXXXXXXXXXXXXXXXXXXXXXXXXXXXXXXXXXXXXXXXXXXXXXB
BXXXXXXXXXXXXXXXXXXXXXXXXXXXXXXXXXXXXXX##VXXXXXXXXZZZZZXXXXXXXXXXXXXXXXXXXXXXXZZZZZZZZZZZZZKKZXXXXXXXXXXXXXXXXXXXXXXXXXXXXXXXXXXXXXXXXXXXXXXXXXXXXXXXXXXXXB
BXXXXXXXXXXXXXXXXXXXXXXXXXXXXXXXXXXXXZZZZZXXXZZZXXZZZZZXXXXXXXXXXXXXXXXXXXXXXXXXXXXXXXXXXXX##VXXXXXXXXXXXXXXXXXXXXXXXXXXXXXXXXXXXXXXXXKKKKKKKKKKKKKXXXXXXXB
BXXXXXXXXXXXXXXXXXXXXXXXXXXXXXXXXXZXXXXXXXXXXXXXXXZZZZZXXXXXXXXXXXXXXXXXXXXXXXXXXXXXXXXXXXX##VXXXXXXXXXXXXXXXX#VDXXXXXXLLLXXXXXXXXXXXXXXXXXXXXXXXXXXXXXXXEB
BXXXXXXXXXXXXXXXXXXXXXXXXXXXXXXXXXXXXXXXXXXXXXXXXXZZZZZXXXXXXXXXXXXXXXXXXXXXXZZZZZZZZZZZZZZZZZXXXXXXXXXXXXXXXXXXXXXXXXXLLLXXXXXXXXXXXXXXXXXXXXXXXXXXXXXXZXB
BXXXXXXXXXXXXXXXXXXXXXXXXZZZXXXZXXXLLLXXXXXXXXXXXXZZZZZXXXXXXXXXXXXXXXXXXXXXXXXXXXXXXXXXXXXXXKXXXXXXXXXXXXXXXXXXXXXXXXXLLLXXXXXXXXXXXXXXXXXXXXXXXXXXXZXXXXB
BXXXXXXXXXXXXXXXXXXXXXXXXXXXXXXXXXXLLLXXXXXXXXXXXXZZZZZXXXXXXXXXXXXXXXXXXXXXXXXXXXXXXXXXXXXXXKXXXXXXXXXXXXXXXXXXXXXXXXXXHXXXXXXXXXXXXXKKKKKKKKKKKKZXXXXXXXB
BXXXXXXXXXXXXXXXXXXXXXZZXXXXXXXXXXXLLLXXXXXXXXXXXXZZZZZXXXXXXXXXXXXXXXXXXXXXZZZZZZZZZZZZZZZZZZXXXXXXXVDDXXXXXXZZZXXXXXXXHXXXXXXXXZZXXXQQQQQQQQQQQQQXXXXXXXB
BXXXXXXXXXXX#VXFXXXXXXXXXXXXXXXXXXXXHXXXXXXXXXXXXXXXXXKXXXXXXXXXXXXXXXXVDDXXXXXXXXXXXXXXXXXXXXXXXXXX#VDD#VDXXXZZZFXXXXXXHXXXXXXXZZZXXXXXXXXXXXXXXXXXXXXXXXB
BXXXXXXXZZZZZZZZXXXZZZZZZZXXXXXXXXXXHXXXXXXXXXXXXXXXXFKXXXXZZXXXXXZXXZZZZZZXXXXXXXXXXXXXXXXXXXXZZZZZZZZZZZZZZZZZZZXXXZZZZZZZZZZZZZZXXXXXXXXXXXXXXXXXXXXXXXB
BZZZZZZZZZZZZZZZWWWZZZZZZZZZZZZZZZZZZZZZZZZZZZZZZZZZZZZWWWWZZZZZZZZWWZZZZZZWWWWWWWWWWWWWWWWWWWWZZZZZZZZZZZZZZZZZZZWWWZZZZZZZZZZZZZZZZZZZZZZZZZZZZZZZZZZZZZB
