BXXXXXXXXXXXXXXXXXXXXXXXXXXXXXXXRCRXXXXXXXXXXXXXXXXXXXXXXXXXRCRXXXXXRCXXXXXXXXXXXXXXXXRRQQQQQRRXXXCRXXXXXXXXXXXRRRCXXXXXXXXXXXXXXXXXXXXXXXB
BXXXXXXXXXXXXXXXXXXXXXXXXXXXXXXXXXXXXXXXXXXXXXXXXXXXXXXXXXXXXXXXXXXXXXXXXXXXXXXXXXXXXXXRRRRRRRXXXXXXXXXXXXXXXXXXXXXXXXXXXXXXXXXXXXXXXXXXXXB
BXXXXXXXXXXXXXXXXXXXXXXXXXXXXXXXXXXXXXXXXXXXXXXXXXXXXXXXXXLLLXXXXXXXXXXXXXXXXXXXXXXXXXXXXXXXXXXXXXXXXXXXXXXXXXXXXXXXXXXXXXXXXXXXXXXXXXXXXXB
BXXXXXXXXXXXLLLXXXXXXXXXFXXXXXXXXXXXXXXXXXOOXXKXXOOXXXXXXXLLLXXXXXXXXXXXXXXXXXXXXXXXXXXXXXXXXXXXXXXXXXXXXXXXXXXXXXXXXXXXXXXXXXOOOKKOOOOOOOB
BXXXXXXXXXXXLLLXXXXXXXXOOOOXXXXXXXXXXXXXOXXXXXXXXXXKXXXXXXLLLXXXXXXXXXXXXLLLXXXXXXXXXFXXXXXXXXXXXXXXXXXXXXXXXXXXOXXXXXXXXXXXXXOOOKKOOOOOOOB
BXXXXXXXXXXXLLLXXXXXXXXXXXXXXXXXXXXXXXOXXXXXXXXXXXXXKXXXXXXHXXXXXXXXXXXXXLLLXXXXXXXXXKXXXXXXXXXXXXXXXXXXXXXXXXOXXXXXXXXXXXXXXOOOOKKOOOOOOOB
BXXXXXXXXXXXXHXXXXXXXXXXXXXXXXOOXXXOOXXXXXXXXXXXXXXXXKXXXXXHXXXXXXXXXXFXXLLLXXXXXXXKXXXXKKKKKXXXXXXX##VXXXXXXXXXXXXXXXXXXXXXXOOOOKKOOOOOOOB
BXXXXXXXXXXXXHXXXXXXXXXXXXXXXXXXXXXXXXXXXXXXXXXXXXXXXXXXXXXHXXXXXXXXXXKXXXHXXXXXXKXXXXXXXXXXXXXXXXXOOOOXKXOMOXXXXXXXXXXXXXXXOOOOOKKOOOOOOOB
BXXXXXXXXXXXXHXXXXXXXXXXXXX#VDXXXXXXXXXXXXXXXXXXXXXXXXXXXFXHXXXOOOOOXXKXXXHXXXXXXXXXXXXXXXXXXXXXXXXXXXXXXXXOXXXXXXXXXXXXXXXXOOOOOXXXKKKKKXB
BOXXXXXXXXXXXHXXXXXXXXXXOOXOOXXXXXXXXXXXXXXXXXXXXXXXXXXXOOOOOOOOOOOOXXKXXXHXXXXKXXXXXXXXXXXXXXXXOOXXXXXXXXXXXXXXXXXXXXXXXXXXOOOOOFXXKKKKKEB
BOOXXXXXXXXXXHXXOXXOXMXOOOWOOOXXXXXXXXXXXXXXXXXXXXXXXXOOOOOOOOOOOOOOXXXMXXHXXXXXXX#VDXOOOOOOOOOXXXXXXXXXXXXXXXXXXXOXXMXXMXXOOOOOOKKOOOOOOOB
BOOOOOOOOOOOOOOOOWWOOOOOOOUOOOOWWWWWWWWWWWWWWWWWWWWWWOOOOOOOOOOOOOOOOOOOOOOOOOOOOOOOOOOOOOOOOOOWWWWWWWWWWWWWWWWWWWOOOOOOOOOOOOOOOWWOOOOOOOB