XXXXXXXXXXXXXXXXXXXXXXXXXXXXXXXXXXXXXXXXXXXXXXXXXXXXXXXXXXXXXXXXXXXXXXXXXXXXXXXXXXXXXXXXXXXXXXXX
XXXXXXXXXXXXXXXXXXXXXXXXXXXXXXXXXXXXXXXXXXXXXXXXXXXXXXXXXXXXXXXXXXXXXXXXXXXXXXXXXXXXXXXXXXXXXXXX
XXXXXXXXXXXXXXXXXXXXXXXXXXXXXXXXXXXXXXXXXXXXXXXXXXXXXXXXXXXXXXXXXXXXXXXXXXXXXXXXXXXXXXXXXXXXXXXX
XXXXXXXXXXXXXXXXXXXXXXXXXXXXXXXXXXXXXXXXXXXXXXXXXXXXXXXXXXXXXXXXXXXXXXXXXXXXXXXXXXXXXXXXXXXXXXXX
XXXXXXXXXXXXXXXXXXXXXXXXXXXXXXXXXXXXXXXXXXXXXXXXXXXXXXXXXXXXXXXXXXXXXXXXXXXXXXXXXXXXXXXXXXXXXXXX
XXXXXXXXXXXXXXXXXXXXXXXXXXXXXXXXXXXXXXXXXXXXXXXXXXXXXXXXXXXXXXXXXXXXXXXXXXXXXXXXXXXXXXXXXXXXXXXX
XXXXXXXXXXXXXXXXXXXXXXXXXXXXXXXXXXXXXXXXXXXXXXXXXXXXXXXXXXXXXXXXXXXXXXXXXXXXXXXXXXXXXXXXXXXXXXXX
XXXXXXXXXXXXXXXXXXXXXXXXXSSXXSSXXXXXXXXXXXXXXXXXXXXXXXXXKXXXXXXSWWSXXXXXXSSSSSSXXXXXXXXXXXXXXXXX
XXXXXXXXXXXSXXXXXXXXXXXSSSSXXSSXXXXXXXXXXXXXXXXXXXXXXXXXKXXXXXSSSSSSXXXXXXKXXXXXXXXXXXXXXXSSXFXX
XXXXXXXXSXXSXXXXXXXXXSSSSSSXXSSXXXXXXXXXXXXXXXXSSSXXXXXXKXXXXSSSSSSSSXFXXXKXXXXXXXXXXXXXSSSSSSXX
XXXXXSXXSXXSXXXSSXXSSSSSSSSWWSSXXXXSSWSSWSSWSSSSSSSXXXXXKXXFSSSSSSSSSSSSSSSSSSSSSSWWSSSSSSSSSSSS
WWWSSSSSSSSSSSSSSSSSSSSSSSSWWSSSSSSSSSSSSSSSSSSSSSSSSSSSSSSSSSSSSSSSSSSSSSSSSSSSSSWWSSSSSSSSSSSS