BXXXXXXXXXXX
BXXXXXXXXXXX
BXXXXXXXXXXX
BXXXXXXXXXXX
BXXXXXXXXXXX
BXXXXXXXXXXX
BXXXXXXXXFXX
BXXXXXXXXXXX
BXXXXXXXXXXX
BXXXXXKXXXXX
BXXXGGGGGGGG
BGGGGGGGGGGG
