BXXXXXXXXXXXXXXXXXXXXXXLLLXXXXXXXXXXXXXXXXXXXXXXXXXXXXXXXXXXXXXXXXXXXXXXXXXXXXXXXXXXXXXXXXXXXXXXXCXXXCXXXCXXXCXXXCXXXCXXXCXXXXXXXB
BXXXXXXXXXXXXXXXXXXXXXXLLLXXXXXXXXXXXXXXXXXXXXXXXXXXXXXXXXXXXXXXXXXXXXXXXXXXXXXXXXXXXXXXXXXXXXXXXXXXXXXXXXXXXXXXXXXXXXXXXXXXXXXXXB
BXXXXXXXXXXXXXXXXXXXXXXLLLXXXXXXXXXXXXXXXXXXXXXXXXXXXXXXXXXXXXXXXXXXXXXXXXXXXXXXXXXXXXXXXXXXXXXXXXXXXXXXXXXXXXXXXXXXXXXXXXXXXXXXXB
BXXXXXXXXXXXXXXXXXXXXXXXHXXXXXXXXXXXXXXXXXXXXXXXXXXXXXXXXXXXXXXXXXXXXXXXXXXXXXXXXXXXXXXXXXIIIXXXXXXXXXXXXXXXXXXXXXXXXXXXXXXXXXXXXB
BXXXXXXXXXXXXXXXXXXXXXXXHXXXXXXXXXXXXXXXXXXXXXXXXXXXXIIIIXXXXXXXXXXXXXXXXXXXIIKKKIIXXXIIXXXXXXXXXXXXXXXXXXXXXXXXXXXXXXXXXXXXXXXXXB
BXXXXXXXXXXXXXXXXXXXXXXXHXXXXXXXXXXXXXXXXXXXXXXXXXXXXIIIIXXXXXXXXXXXXXXXXXXXXXXXXXXXXXXXXXXXXXXXXXXXXXXXXXXXXXXXXXXXXXXXXXXXXXXXXB
BXXXXXXXXXXXXXXXXXXXXXIIIIIXXXXXXXXXXXFXXXXXXXXXXXXXXIIIIXXXXXXXXXXXXXXXXIIXXXXXXXXXXXXXXXXXXXXXXXXXXXXXXXXXXXXXXXXIIIXXXXXXXXXXXB
BXXXXXXXXXXXXXXXXXXXXIIIIIIIXXXXXXXXXXIXXXXXXXXXXXXXIIIIXXXXXXXXXXXXXXXXXXXXXXXXXXXXXXXXXXXXXXXXXXXXXXFXXXXXXXXXXXXIIIXXXXXXXXXXXB
BXXXXXXXXXXXXXXXXXXXIIIIIIIIIXXXXXXXXXXXXXXXXXXXXXXXIIIIXXXXXXXXXXXXXIIIXXXXXXXFXXXXXXXXXXXXXXXXXXXXXXXXXIXXXXXXXXIIIIIXXXXXXXXXXB
BXXXXXXXXXXXXXXXXXXIIIIIIIIIIIXXXXXXXXXXXXXXXXXXXXXXIIIIFXXXXXXXXXXXXXXXXXXXXXIIIXXXXXXXXXXXXXXXXXXXXXXXXIXXIXXIXXIIIIIXXXXXXXXXXB
BSSXXXXXXXXXXXXXXXIIIIIIIIIIIIIIWWWIIWWWIIWWWIIWWWIIIIIIIXXXXIIIIIIIXXXXXXXXXXXXXXXXXXXXXXXXIIIIIIIIIIIIIIIIIIIIIIIIIIIFXXXXXXXXEB
BSSSSIIIIIIWWWIIIIIIIIIIIIIIIIIIIIIIIIIIIIIIIIIIIIIIIIIIIWWWWIIIIIIIWWWWWWWWWWWWWWWWWWWWWWWWIIIIIIIIIIIIIIIIIIIIIIIIIIIIXXXIIIGGGB