BXXXXXXXXXXXXXXXXXXXXXLLLXXXXXXXXXXXXXXXXXXXXXXXXXXXXXXXXXXXXXXXXXXXXXXXXXXXXXXXXXXXXXXXXXXXXXXXXXXXXXXXXXXXXXXXB
BXXXXXXXXXXXXXXXXXXXXXLLLXXXXXXXXXXXXXXXXXXXXXXXXXXXXXXXXXXXXXXXXXXXXXXXXXXXXXXXXXXXXXXXXXXXXXXXXXXXXXXXXXXXXXXXB
BXXXXXXXXXXXXXXXXXXXXXLLLXXXXXXXXXXXXXXXXXXXXXXXXXXXXXXXXXXXXXXXXXXXXXXXXXXXXXXXXXXXXXXXXXXXXXXXXXXXXXXXXXXXXXXXB
BXXXXXXXXXXXXXXXXXXXXXXHXXXXXXXXXXXXXXXXXXXXXXXXXXXXXXXXXXXXXXXXXXXXXXXXXXXXXXXXXXXXXXXXXXXXXXXXXXXXXXXXXXXXXXXXB
BXXXXXXXXXXXXXXXXXXXXXXHXXXXXXXXXXXXXXXXXXXXXIIIIXXXXXXXXXXXXXXXXXXIIKKIIXXXIIXXXXXXXXXXXXXXXXXXXXXXXXXXXXXXXXXXB
BXXXXXXXXXXXXXXXXXXXXXXHXXXXXXXXXXXXXXXXXXXXXIIIIXXXXXXXXXXXXXXXXXXXXXXXXXXXXXXXXXXXXXXXXXXXXXXXXXXXXXXXXXXXXXXXB
BXXXXXXXXXXXXXXXXXXXXIIIIIXXXXXXXXXXFXXXXXXXXIIIIXXXXXXXXXXXXXXXIIXXXXXXXXXXXXXXXXXXXXXXXXXXXXXXXXXIIIXXXXXXXXXXB
BXXXXXXXXXXXXXXXXXXXIIIIIIIXXXXXXXXXIXXXXXXXIIIIXXXXXXXXXXXXXXXXXXXXXXXXXXXXXXXXXXXXXXFXXXXXXXXXXXXIIIXXXXXXXXXXB
BXXXXXXXXXXXXXXXXXXIIIIIIIIIXXXXXXXXXXXXXXXXIIIIXXXXXXXXXXXXIIIXXXXXXFXXXXXXXXXXXXXXXXXXIXXXXXXXXIIIIIXXXXXXXXXXB
BXXXXXXXXXXXXXXXXXIIIIIIIIIIIXXXXXXXXXXXXXXXIIIIFXXXXXXXXXXXXXXXXXXXXIIXXXXXXXXXXXXXXXXXIXXIXXIXXIIIIIXXXXXXXXXXB
BSSXXXXXXXXXXXXXXIIIIIIIIIIIIIWWWIIWWWIWWWIIIIIIIXXXIIIIIIIXXXXXXXXXXXXXXXXXXXXIIIIIIIIIIIIIIIIIIIIIIIFXXXXXXXXXB
BSSSSIIIIIWWWIIIIIIIIIIIIIIIIIIIIIIIIIIIIIIIIIIIIWWWIIIIIIIWWWWWWWWWWWWWWWWWWWWIIIIIIIIIIIIIIIIIIIIIIIIXXXIIIGGGB