BXXXXXXXXXXXXXXXXXXXXXLLLXXXXXXXXXXXXXXXXXXXXXXXXXXXXXXXXXXXXXXXXXXXXXXXXXXXXXXXXXXXXXXXXXXXXXXXXXXXXXXXXXXXXXXXXB
BXXXXXXXXXXXXXXXXXXXXXLLLXXXXXXXXXXXXXXXXXXXXXXXXXXXXXXXXXXXXXXXXXXXXXXXXXXXXXXXXXXXXXXXXXXXXXXXXXXXXXXXXXXXXXXXXB
BXXXXXXXXXXXXXXXXXXXXXLLLXXXXXXXXXXXXXXXXXXXXXXXXXXXXXXXXXXXXXXXXXXXXXXXXXXXXXXXXXXXXXXXXXXXXXXXXXXXXXXXXXXXXXXXXB
BXXXXXXXXXXXXXXXXXXXXXXHXXXXXXXXXXXXXXXXXXXXXXXXXXXXXXXXXXXXXXXXXXXXXXXXXXXXXXXXXXXXXXXXXXXXXXXXXXXXXXXXXXXXXXXXXB
BXXXXXXXXXXXXXXXXXXXXXXHXXXXXXXXXXXXXXXXXXXXXIIIIXXXXXXXXXXXXXXXXXXIIKKKIIXXXIIXXXXXXXXXXXXXXXXXXXXXXXXXXXXXXXXXXB
BXXXXXXXXXXXXXXXXXXXXXXHXXXXXXXXXXXXXXXXXXXXXIIIIXXXXXXXXXXXXXXXXXXXXXXXXXXXXXXXXXXXXXXXXXXXXXXXXXXXXXXXXXXXXXXXXB
BXXXXXXXXXXXXXXXXXXXXIIIIIXXXXXXXXXXFXXXXXXXXIIIIXXXXXXXXXXXXXXXIIXXXXXXXXXXXXXXXXXXXXXXXXXXXXXXXXXIIIXXXXXXXXXXXB
BXXXXXXXXXXXXXXXXXXXIIIIIIIXXXXXXXXXIXXXXXXXIIIIXXXXXXXXXXXXXXXXXXXXXXXXXXXXXXXXXXXXXXFXXXXXXXXXXXXIIIXXXXXXXXXXXB
BXXXXXXXXXXXXXXXXXXIIIIIIIIIXXXXXXXXXXXXXXXXIIIIXXXXXXXXXXXXIIIXXXXXXXFXXXXXXXXXXXXXXXXXXIXXXXXXXXIIIIIXXXXXXXXXXB
BXXXXXXXXXXXXXXXXXIIIIIIIIIIIXXXXXXXXXXXXXXXIIIIFXXXXXXXXXXXXXXXXXXXXIIIXXXXXXXXXXXXXXXXXIXXIXXIXXIIIIIXXXXXXXXXXB
BSSXXXXXXXXXXXXXXIIIIIIIIIIIIIWWWIIWWWIWWWIIIIIIIXXXIIIIIIIXXXXXXXXXXXXXXXXXXXXXIIIIIIIIIIIIIIIIIIIIIIIFXXXXXXXXEB
BSSSSIIIIIWWWIIIIIIIIIIIIIIIIIIIIIIIIIIIIIIIIIIIIWWWIIIIIIIWWWWWWWWWWWWWWWWWWWWWIIIIIIIIIIIIIIIIIIIIIIIIXXXIIIGGGB