BXXXXXXXXXXXXXXXXXXXXXXLLLXXXXXXXXXXXXXXXXXXXXXXXXXXXXXXXXXXXXXXXXXXXXXXXXXXXXXXXXXXXXXXXXXXXXCXXXCXXXCXXXCXXXCXXXCXXXCXXXXXXXB
BXXXXXXXXXXXXXXXXXXXXXXLLLXXXXXXXXXXXXXXXXXXXXXXXXXXXXXXXXXXXXXXXXXXXXXXXXXXXXXXXXXXXXXXXXXXXXXXXXXXXXXXXXXXXXXXXXXXXXXXXXXXXXB
BXXXXXXXXXXXXXXXXXXXXXXLLLXXXXXXXXXXXXXXXXXXXXXXXXXXXXXXXXXXXXXXXXXXXXXXXXXXXXXXXXXXXXXXXXXXXXXXXXXXXXXXXXXXXXXXXXXXXXXXXXXXXXB
BXXXXXXXXXXXXXXXXXXXXXXXHXXXXXXXXXXXXXXXXXXXXXXXXXXXXXXXXXXXXXXXXXXXXXXXXXXXXXXXXXXXXXXIIIXXXXXXXXXXXXXXXXXXXXXXXXXXXXXXXXXXXXB
BXXXXXXXXXXXXXXXXXXXXXXXHXXXXXXXXXXXXXXXXXXXXXXXXXXIIIIXXXXXXXXXXXXXXXXXXIIKKKIIXXXIIXXXXXXXXXXXXXXXXXXXXXXXXXXXXXXXXXXXXXXXXXB
BXXXXXXXXXXXXXXXXXXXXXXXHXXXXXXXXXXXXXXXXXXXXXXXXXXIIIIXXXXXXXXXXXXXXXXXXXXXXXXXXXXXXXXXXXXXXXXXXXXXXXXXXXXXXXXXXXXXXXXXXXXXXXB
BXXXXXXXXXXXXXXXXXXXXXIIIIIXXXXXXXXXXXFXXXXXXXXXXXXIIIIXXXXXXXXXXXXXXXIIXXXXXXXXXXXXXXXXXXXXXXXXXXXXXXXXXXXXXXXXIIIXXXXXXXXXXXB
BXXXXXXXXXXXXXXXXXXXXIIIIIIIXXXXXXXXXXIXXXXXXXXXXXIIIIXXXXXXXXXXXXXXXXXXXXXXXXXXXXXXXXXXXXXXXXXXXXXFXXXXXXXXXXXXIIIXXXXXXXXXXXB
BXXXXXXXXXXXXXXXXXXXIIIIIIIIIXXXXXXXXXXXXXXXXXXXXXIIIIXXXXXXXXXXXXIIIXXXXXXXFXXXXXXXXXXXXXXXXXXXXXXXXXIXXXXXXXXIIIIIXXXXXXXXXXB
BXXXXXXXXXXXXXXXXXXIIIIIIIIIIIXXXXXXXXXXXXXXXXXXXXIIIIFXXXXXXXXXXXXXXXXXXXXIIIXXXXXXXXXXXXXXXXXXXXXXXXIXXIXXIXXIIIIIXXXXXXXXXXB
BSSXXXXXXXXXXXXXXXIIIIIIIIIIIIIIWWWIIWWWIWWWIWWWIIIIIIIXXXIIIIIIIXXXXXXXXXXXXXXXXXXXXXXXXIIIIIIIIIIIIIIIIIIIIIIIIIIIFXXXXXXXXEB
BSSSSIIIIIIWWWIIIIIIIIIIIIIIIIIIIIIIIIIIIIIIIIIIIIIIIIIWWWIIIIIIIWWWWWWWWWWWWWWWWWWWWWWWWIIIIIIIIIIIIIIIIIIIIIIIIIIIIXXXIIIGGGB