BXXXXXXXXXXXXXXXXXXXXXXXXXXXXXXXXXXXXXXXXXXXXXXXXXXXXXXXXXXXXXXXXXXXXXXXXXXXXXXXXXXXXXXXCCCCCXXXXXXXXXXXXXXXXXXXXB
BXXXXXXXXXXXXXXXXXXXXXXXXXXXXXXXXXXXXXXXXXXXXXXXXXXXXXXXXXXXXXXXXXXXXXXXXXXXXXXXXXXXXXXXXXXXXXXXXXXXXXXXXXXXXXXXXB
BXXXXXXXXXXXXXXXXXXXXXXXXXXXXXXXXXXXXXXXXXXXXXXXXXXXXXXXXXXXXXXXXXXXXXXXXXXXXXXXXXXXXXXXXXXXXXXXXXXXXXXXXXXXXXXXXB
BXXXXXXXXXXXXXXXXXXXXXXXXXXXXXXXXXXXXXXXXXXXXXXXXXXXXXXXXXXXXXXXXXXXXXXXXXXXXXXXXXXXXXXXXXXXXXXXXXXXXXXXXXXXXXXXXB
BXXXXXXXXXXXXXXXXXXXXXXXXXXXXXXXXXXXXXXXXXXXXXXXXXXXXXXXXXXXXXXXXXXXXXXXXXXXXXXXXXXXXXXXXXXXXXXXXXXXXXXXXXXXXXXXXB
BXXXXXXXXXXXXXXXXXXXXXXXXXXXXXXXXXXXXXXXXXXXXXXXXXXXXXXXXXXXXXXXXXXXXXXXXXXXXXXXXXXXXXXXXXXXXXXXXXXXXXXXXXXXXXXXXB
BXXXXXXXXXXXXXXXXXXXXXXXXXXXXXXXXXXXXXXXXXXXXXXXXXXXXXXXXXXXXXXXXXXXXXXXXXXXXXXXXXXXXXXXXXXXXXXXXXXXXXXXXXXXXXXXXB
BXXXXXXXXXXXXXXXXXXXXXXXXXXXXXSSXXXSSSXXXXXXXXXXXXXXXXXXXXXXXXXXXXXXXXXXXXXSWWWSXXXXXXXSSSSSSSXXXXXXXXXXXXXXXXXXXB
BXXXXXXXXXXXXXSSXXXXXXXXXXXXSSSSXXXSSSXXXXXXXXXXXXXXXXXXXXXXXXXXXXXXKXXXXXSSSSSSSXXXXXXXKXXXXXXXXXXXXXXXXXSSSXFXXB
BXXXXXXXXXSSXXSSXXXXXXXXXXSSSSSSXXXSSSXXXXXXXXXXXXXXXXXXXXSSSSXXXXXXKXXXXSSSSSSSSSXXFXXXKXXXXXXXXXXXXXXXSSSSSSSXEB
BXXXXXSSXXSSXXSSXXXSSSXXSSSSSSSSWWWSSSXXXXXSSWWSSWWSSWWSSSSSSSSXXXXXKXXFSSSSSSSSSSSSSSSSSSSSSSSSSWWWSSSSSSSSSSSSSB
BWWWSSSSSSSSSSSSSSSSSSSSSSSSSSSSWWWSSSSSSSSSSSSSSSSSSSSSSSSSSSSSSSSSSSSSSSSSSSSSSSSSSSSSSSSSSSSSSWWWSSSSSSSSSSSSSB